기준_년_코드,기준_분기_코드,상권_구분_코드,상권_구분_코드_명,상권 코드,총 상주인구 수,남성 상주인구 수,여성 상주인구 수
2021,4,U,관광특구,1001496,29,16,13
2021,4,U,관광특구,1001495,9639,4250,5389
2021,4,U,관광특구,1001494,1977,1303,674
2021,4,U,관광특구,1001493,2703,1294,1409
2021,4,U,관광특구,1001492,1089,403,686
2021,4,U,관광특구,1001491,5174,2451,2723
2021,4,R,전통시장,2130326,1281,639,642
2021,4,R,전통시장,2130325,1895,942,953
2021,4,R,전통시장,2130324,1129,555,574
2021,4,R,전통시장,2130323,1515,782,733
2021,4,R,전통시장,2130322,1121,581,540
2021,4,R,전통시장,2130321,1443,722,721
2021,4,R,전통시장,2130320,989,508,481
2021,4,R,전통시장,2130319,1276,657,619
2021,4,R,전통시장,2130318,773,343,430
2021,4,R,전통시장,2130317,1055,561,494
2021,4,R,전통시장,2130316,97,50,47
2021,4,R,전통시장,2130315,1089,555,534
2021,4,R,전통시장,2130314,3876,1922,1954
2021,4,R,전통시장,2130313,4989,2379,2610
2021,4,R,전통시장,2130312,913,446,467
2021,4,R,전통시장,2130311,2340,1157,1183
2021,4,R,전통시장,2130310,112,63,49
2021,4,R,전통시장,2130308,6,3,3
2021,4,R,전통시장,2130307,37,22,15
2021,4,R,전통시장,2130306,408,199,209
2021,4,R,전통시장,2130305,84,38,46
2021,4,R,전통시장,2130304,2,1,1
2021,4,R,전통시장,2130303,1142,546,596
2021,4,R,전통시장,2130302,272,117,155
2021,4,R,전통시장,2130301,110,58,52
2021,4,R,전통시장,2130299,2,1,1
2021,4,R,전통시장,2130296,197,93,104
2021,4,R,전통시장,2130295,1370,685,685
2021,4,R,전통시장,2130294,588,280,308
2021,4,R,전통시장,2130293,421,212,209
2021,4,R,전통시장,2130292,11,4,7
2021,4,R,전통시장,2130291,168,83,85
2021,4,R,전통시장,2130290,2084,929,1155
2021,4,R,전통시장,2130288,19,7,12
2021,4,R,전통시장,2130287,160,99,61
2021,4,R,전통시장,2130286,51,25,26
2021,4,R,전통시장,2130285,865,400,465
2021,4,R,전통시장,2130284,13,10,3
2021,4,R,전통시장,2130283,439,254,185
2021,4,R,전통시장,2130282,336,165,171
2021,4,R,전통시장,2130281,83,37,46
2021,4,R,전통시장,2130280,5,3,2
2021,4,R,전통시장,2130279,2047,1009,1038
2021,4,R,전통시장,2130278,655,307,348
2021,4,R,전통시장,2130277,1363,701,662
2021,4,R,전통시장,2130276,68,43,25
2021,4,R,전통시장,2130275,564,288,276
2021,4,R,전통시장,2130274,774,374,400
2021,4,R,전통시장,2130273,721,365,356
2021,4,R,전통시장,2130272,10,7,3
2021,4,R,전통시장,2130271,550,241,309
2021,4,R,전통시장,2130270,72,32,40
2021,4,R,전통시장,2130269,97,42,55
2021,4,R,전통시장,2130268,1587,765,822
2021,4,R,전통시장,2130267,280,157,123
2021,4,R,전통시장,2130266,493,230,263
2021,4,R,전통시장,2130265,144,84,60
2021,4,R,전통시장,2130264,690,336,354
2021,4,R,전통시장,2130263,8,5,3
2021,4,R,전통시장,2130262,817,396,421
2021,4,R,전통시장,2130261,1689,777,912
2021,4,R,전통시장,2130260,505,245,260
2021,4,R,전통시장,2130258,101,47,54
2021,4,R,전통시장,2130257,591,339,252
2021,4,R,전통시장,2130256,46,22,24
2021,4,R,전통시장,2130255,1053,661,392
2021,4,R,전통시장,2130254,2,2,0
2021,4,R,전통시장,2130253,45,39,6
2021,4,R,전통시장,2130250,8,6,2
2021,4,R,전통시장,2130249,150,73,77
2021,4,R,전통시장,2130247,471,236,235
2021,4,R,전통시장,2130246,1705,934,771
2021,4,R,전통시장,2130245,178,121,57
2021,4,R,전통시장,2130244,883,434,449
2021,4,R,전통시장,2130243,74,36,38
2021,4,R,전통시장,2130242,380,184,196
2021,4,R,전통시장,2130241,1456,749,707
2021,4,R,전통시장,2130240,19,15,4
2021,4,R,전통시장,2130238,1183,579,604
2021,4,R,전통시장,2130237,282,144,138
2021,4,R,전통시장,2130236,2057,1005,1052
2021,4,R,전통시장,2130235,1058,544,514
2021,4,R,전통시장,2130234,50,27,23
2021,4,R,전통시장,2130233,1479,736,743
2021,4,R,전통시장,2130232,818,428,390
2021,4,R,전통시장,2130231,1549,806,743
2021,4,R,전통시장,2130230,226,118,108
2021,4,R,전통시장,2130229,679,395,284
2021,4,R,전통시장,2130228,233,121,112
2021,4,R,전통시장,2130227,223,111,112
2021,4,R,전통시장,2130226,26,13,13
2021,4,R,전통시장,2130225,3033,1478,1555
2021,4,R,전통시장,2130224,145,70,75
2021,4,R,전통시장,2130223,559,272,287
2021,4,R,전통시장,2130222,167,85,82
2021,4,R,전통시장,2130221,2003,957,1046
2021,4,R,전통시장,2130220,3,2,1
2021,4,R,전통시장,2130219,1043,483,560
2021,4,R,전통시장,2130218,76,43,33
2021,4,R,전통시장,2130217,340,151,189
2021,4,R,전통시장,2130216,969,471,498
2021,4,R,전통시장,2130214,657,320,337
2021,4,R,전통시장,2130213,455,225,230
2021,4,R,전통시장,2130212,375,188,187
2021,4,R,전통시장,2130211,849,424,425
2021,4,R,전통시장,2130210,1293,593,700
2021,4,R,전통시장,2130209,1612,801,811
2021,4,R,전통시장,2130208,1237,608,629
2021,4,R,전통시장,2130207,191,95,96
2021,4,R,전통시장,2130206,47,27,20
2021,4,R,전통시장,2130205,129,72,57
2021,4,R,전통시장,2130204,735,359,376
2021,4,R,전통시장,2130203,565,277,288
2021,4,R,전통시장,2130202,1178,576,602
2021,4,R,전통시장,2130201,1426,754,672
2021,4,R,전통시장,2130200,264,130,134
2021,4,R,전통시장,2130199,828,466,362
2021,4,R,전통시장,2130198,675,320,355
2021,4,R,전통시장,2130197,61,52,9
2021,4,R,전통시장,2130196,12,7,5
2021,4,R,전통시장,2130195,2281,1068,1213
2021,4,R,전통시장,2130194,756,389,367
2021,4,R,전통시장,2130193,64,27,37
2021,4,R,전통시장,2130192,35,18,17
2021,4,R,전통시장,2130191,497,240,257
2021,4,R,전통시장,2130190,339,183,156
2021,4,R,전통시장,2130189,23,15,8
2021,4,R,전통시장,2130188,71,30,41
2021,4,R,전통시장,2130187,271,119,152
2021,4,R,전통시장,2130186,2098,989,1109
2021,4,R,전통시장,2130185,874,381,493
2021,4,R,전통시장,2130183,2863,1430,1433
2021,4,R,전통시장,2130182,417,220,197
2021,4,R,전통시장,2130181,647,357,290
2021,4,R,전통시장,2130180,578,286,292
2021,4,R,전통시장,2130179,1402,317,1085
2021,4,R,전통시장,2130178,551,248,303
2021,4,R,전통시장,2130177,262,126,136
2021,4,R,전통시장,2130176,286,132,154
2021,4,R,전통시장,2130175,3,1,2
2021,4,R,전통시장,2130173,137,60,77
2021,4,R,전통시장,2130172,111,69,42
2021,4,R,전통시장,2130171,1194,527,667
2021,4,R,전통시장,2130170,26,14,12
2021,4,R,전통시장,2130169,1753,807,946
2021,4,R,전통시장,2130168,345,178,167
2021,4,R,전통시장,2130167,1497,737,760
2021,4,R,전통시장,2130166,201,99,102
2021,4,R,전통시장,2130165,489,243,246
2021,4,R,전통시장,2130164,8,6,2
2021,4,R,전통시장,2130163,1517,719,798
2021,4,R,전통시장,2130162,140,84,56
2021,4,R,전통시장,2130161,148,59,89
2021,4,R,전통시장,2130160,106,52,54
2021,4,R,전통시장,2130159,1767,893,874
2021,4,R,전통시장,2130158,1007,420,587
2021,4,R,전통시장,2130157,1880,957,923
2021,4,R,전통시장,2130155,4,3,1
2021,4,R,전통시장,2130154,5,2,3
2021,4,R,전통시장,2130153,174,141,33
2021,4,R,전통시장,2130152,754,415,339
2021,4,R,전통시장,2130151,162,79,83
2021,4,R,전통시장,2130150,1210,591,619
2021,4,R,전통시장,2130149,2292,1123,1169
2021,4,R,전통시장,2130148,1244,634,610
2021,4,R,전통시장,2130147,825,395,430
2021,4,R,전통시장,2130146,3436,1690,1746
2021,4,R,전통시장,2130145,933,450,483
2021,4,R,전통시장,2130144,618,297,321
2021,4,R,전통시장,2130143,592,294,298
2021,4,R,전통시장,2130141,1122,554,568
2021,4,R,전통시장,2130140,227,119,108
2021,4,R,전통시장,2130139,2207,1123,1084
2021,4,R,전통시장,2130138,210,97,113
2021,4,R,전통시장,2130137,507,259,248
2021,4,R,전통시장,2130136,451,232,219
2021,4,R,전통시장,2130135,921,464,457
2021,4,R,전통시장,2130134,137,67,70
2021,4,R,전통시장,2130133,1598,794,804
2021,4,R,전통시장,2130132,485,247,238
2021,4,R,전통시장,2130131,25,15,10
2021,4,R,전통시장,2130130,54,29,25
2021,4,R,전통시장,2130129,1457,716,741
2021,4,R,전통시장,2130128,1776,918,858
2021,4,R,전통시장,2130127,150,82,68
2021,4,R,전통시장,2130126,55,27,28
2021,4,R,전통시장,2130125,839,407,432
2021,4,R,전통시장,2130124,16,8,8
2021,4,R,전통시장,2130123,331,161,170
2021,4,R,전통시장,2130122,229,108,121
2021,4,R,전통시장,2130121,32,27,5
2021,4,R,전통시장,2130120,219,83,136
2021,4,R,전통시장,2130119,533,243,290
2021,4,R,전통시장,2130118,605,304,301
2021,4,R,전통시장,2130117,937,454,483
2021,4,R,전통시장,2130116,249,124,125
2021,4,R,전통시장,2130115,2128,1085,1043
2021,4,R,전통시장,2130114,105,55,50
2021,4,R,전통시장,2130113,163,81,82
2021,4,R,전통시장,2130112,2061,1003,1058
2021,4,R,전통시장,2130111,1962,976,986
2021,4,R,전통시장,2130110,1649,867,782
2021,4,R,전통시장,2130109,836,424,412
2021,4,R,전통시장,2130108,316,162,154
2021,4,R,전통시장,2130107,175,87,88
2021,4,R,전통시장,2130106,1323,696,627
2021,4,R,전통시장,2130105,1172,584,588
2021,4,R,전통시장,2130104,595,300,295
2021,4,R,전통시장,2130103,236,133,103
2021,4,R,전통시장,2130102,76,32,44
2021,4,R,전통시장,2130101,272,141,131
2021,4,R,전통시장,2130100,427,211,216
2021,4,R,전통시장,2130099,85,52,33
2021,4,R,전통시장,2130098,1239,541,698
2021,4,R,전통시장,2130097,1527,763,764
2021,4,R,전통시장,2130095,416,274,142
2021,4,R,전통시장,2130094,65,45,20
2021,4,R,전통시장,2130093,3,3,0
2021,4,R,전통시장,2130092,398,219,179
2021,4,R,전통시장,2130091,688,339,349
2021,4,R,전통시장,2130090,105,63,42
2021,4,R,전통시장,2130089,358,190,168
2021,4,R,전통시장,2130088,4,3,1
2021,4,R,전통시장,2130087,73,32,41
2021,4,R,전통시장,2130086,2184,1194,990
2021,4,R,전통시장,2130085,25,16,9
2021,4,R,전통시장,2130084,210,99,111
2021,4,R,전통시장,2130083,826,421,405
2021,4,R,전통시장,2130082,228,118,110
2021,4,R,전통시장,2130081,1945,925,1020
2021,4,R,전통시장,2130080,58,28,30
2021,4,R,전통시장,2130079,23,15,8
2021,4,R,전통시장,2130078,1323,605,718
2021,4,R,전통시장,2130077,76,42,34
2021,4,R,전통시장,2130076,631,319,312
2021,4,R,전통시장,2130075,132,61,71
2021,4,R,전통시장,2130074,484,247,237
2021,4,R,전통시장,2130073,519,277,242
2021,4,R,전통시장,2130072,4259,2142,2117
2021,4,R,전통시장,2130071,7,5,2
2021,4,R,전통시장,2130070,1665,845,820
2021,4,R,전통시장,2130069,540,269,271
2021,4,R,전통시장,2130068,1802,921,881
2021,4,R,전통시장,2130067,3520,1694,1826
2021,4,R,전통시장,2130066,1912,932,980
2021,4,R,전통시장,2130065,2688,1354,1334
2021,4,R,전통시장,2130064,198,102,96
2021,4,R,전통시장,2130063,422,205,217
2021,4,R,전통시장,2130062,3,0,3
2021,4,R,전통시장,2130061,63,29,34
2021,4,R,전통시장,2130060,81,41,40
2021,4,R,전통시장,2130059,708,358,350
2021,4,R,전통시장,2130058,112,59,53
2021,4,R,전통시장,2130057,31,18,13
2021,4,R,전통시장,2130056,670,330,340
2021,4,R,전통시장,2130055,1451,756,695
2021,4,R,전통시장,2130054,1199,607,592
2021,4,R,전통시장,2130053,990,515,475
2021,4,R,전통시장,2130052,1317,716,601
2021,4,R,전통시장,2130051,1456,710,746
2021,4,R,전통시장,2130050,1,1,0
2021,4,R,전통시장,2130049,152,97,55
2021,4,R,전통시장,2130048,50,22,28
2021,4,R,전통시장,2130047,13,11,2
2021,4,R,전통시장,2130046,1,1,0
2021,4,R,전통시장,2130042,477,231,246
2021,4,R,전통시장,2130039,3,0,3
2021,4,R,전통시장,2130038,7,5,2
2021,4,R,전통시장,2130036,378,219,159
2021,4,R,전통시장,2130035,316,223,93
2021,4,R,전통시장,2130034,7,4,3
2021,4,R,전통시장,2130033,131,83,48
2021,4,R,전통시장,2130032,161,96,65
2021,4,R,전통시장,2130031,40,27,13
2021,4,R,전통시장,2130024,62,37,25
2021,4,R,전통시장,2130021,8,8,0
2021,4,R,전통시장,2130020,449,226,223
2021,4,R,전통시장,2130019,50,27,23
2021,4,R,전통시장,2130018,133,76,57
2021,4,R,전통시장,2130017,81,51,30
2021,4,R,전통시장,2130016,51,29,22
2021,4,R,전통시장,2130015,810,429,381
2021,4,R,전통시장,2130014,66,39,27
2021,4,R,전통시장,2130013,40,18,22
2021,4,R,전통시장,2130012,2,2,0
2021,4,R,전통시장,2130011,191,102,89
2021,4,R,전통시장,2130010,112,83,29
2021,4,R,전통시장,2130009,1,1,0
2021,4,R,전통시장,2130007,91,41,50
2021,4,R,전통시장,2130005,27,21,6
2021,4,R,전통시장,2130004,315,145,170
2021,4,R,전통시장,2130002,561,274,287
2021,4,R,전통시장,2130001,636,277,359
2021,4,D,발달상권,2120249,1201,545,656
2021,4,D,발달상권,2120248,2253,1121,1132
2021,4,D,발달상권,2120247,1581,722,859
2021,4,D,발달상권,2120246,5959,2872,3087
2021,4,D,발달상권,2120245,2664,1355,1309
2021,4,D,발달상권,2120244,2164,1092,1072
2021,4,D,발달상권,2120243,4057,1951,2106
2021,4,D,발달상권,2120242,3520,1674,1846
2021,4,D,발달상권,2120241,1814,931,883
2021,4,D,발달상권,2120240,3595,1737,1858
2021,4,D,발달상권,2120239,4095,1999,2096
2021,4,D,발달상권,2120238,380,201,179
2021,4,D,발달상권,2120237,3467,1825,1642
2021,4,D,발달상권,2120236,167,92,75
2021,4,D,발달상권,2120235,4454,1873,2581
2021,4,D,발달상권,2120234,2694,1460,1234
2021,4,D,발달상권,2120233,3395,1354,2041
2021,4,D,발달상권,2120232,1002,484,518
2021,4,D,발달상권,2120230,1064,560,504
2021,4,D,발달상권,2120229,2889,1401,1488
2021,4,D,발달상권,2120228,4191,1972,2219
2021,4,D,발달상권,2120227,5442,2524,2918
2021,4,D,발달상권,2120226,2101,994,1107
2021,4,D,발달상권,2120225,3414,1622,1792
2021,4,D,발달상권,2120224,594,284,310
2021,4,D,발달상권,2120223,309,158,151
2021,4,D,발달상권,2120222,746,381,365
2021,4,D,발달상권,2120221,693,345,348
2021,4,D,발달상권,2120220,831,410,421
2021,4,D,발달상권,2120219,1039,527,512
2021,4,D,발달상권,2120218,28,15,13
2021,4,D,발달상권,2120217,3789,1881,1908
2021,4,D,발달상권,2120216,218,98,120
2021,4,D,발달상권,2120215,3513,1636,1877
2021,4,D,발달상권,2120214,761,368,393
2021,4,D,발달상권,2120213,4094,1998,2096
2021,4,D,발달상권,2120212,1481,711,770
2021,4,D,발달상권,2120211,1638,780,858
2021,4,D,발달상권,2120210,4780,2264,2516
2021,4,D,발달상권,2120209,1374,624,750
2021,4,D,발달상권,2120208,3265,1471,1794
2021,4,D,발달상권,2120207,6763,3030,3733
2021,4,D,발달상권,2120206,4039,1894,2145
2021,4,D,발달상권,2120205,1116,543,573
2021,4,D,발달상권,2120204,1595,712,883
2021,4,D,발달상권,2120203,1522,713,809
2021,4,D,발달상권,2120202,1843,860,983
2021,4,D,발달상권,2120201,1880,867,1013
2021,4,D,발달상권,2120200,976,427,549
2021,4,D,발달상권,2120199,996,469,527
2021,4,D,발달상권,2120198,7376,3813,3563
2021,4,D,발달상권,2120197,6012,3041,2971
2021,4,D,발달상권,2120196,1346,647,699
2021,4,D,발달상권,2120195,444,233,211
2021,4,D,발달상권,2120194,2599,1282,1317
2021,4,D,발달상권,2120193,1184,561,623
2021,4,D,발달상권,2120192,6735,3098,3637
2021,4,D,발달상권,2120191,4394,2068,2326
2021,4,D,발달상권,2120190,2274,1022,1252
2021,4,D,발달상권,2120189,5977,2811,3166
2021,4,D,발달상권,2120188,1129,540,589
2021,4,D,발달상권,2120187,5512,2640,2872
2021,4,D,발달상권,2120186,3152,1382,1770
2021,4,D,발달상권,2120185,3768,1830,1938
2021,4,D,발달상권,2120184,5782,2984,2798
2021,4,D,발달상권,2120183,1202,611,591
2021,4,D,발달상권,2120182,1794,934,860
2021,4,D,발달상권,2120181,1000,480,520
2021,4,D,발달상권,2120180,1346,657,689
2021,4,D,발달상권,2120179,4990,2350,2640
2021,4,D,발달상권,2120178,3521,1750,1771
2021,4,D,발달상권,2120177,4597,2309,2288
2021,4,D,발달상권,2120176,4719,2224,2495
2021,4,D,발달상권,2120175,3892,1745,2147
2021,4,D,발달상권,2120174,1550,730,820
2021,4,D,발달상권,2120173,5253,2528,2725
2021,4,D,발달상권,2120172,3843,1921,1922
2021,4,D,발달상권,2120171,3163,1528,1635
2021,4,D,발달상권,2120170,614,292,322
2021,4,D,발달상권,2120169,2053,971,1082
2021,4,D,발달상권,2120168,267,132,135
2021,4,D,발달상권,2120167,3,2,1
2021,4,D,발달상권,2120166,3091,1505,1586
2021,4,D,발달상권,2120165,1604,745,859
2021,4,D,발달상권,2120164,2923,1358,1565
2021,4,D,발달상권,2120163,3696,1722,1974
2021,4,D,발달상권,2120162,2276,1065,1211
2021,4,D,발달상권,2120161,1317,610,707
2021,4,D,발달상권,2120160,3974,1868,2106
2021,4,D,발달상권,2120159,8499,3715,4784
2021,4,D,발달상권,2120158,2123,1220,903
2021,4,D,발달상권,2120157,8255,4316,3939
2021,4,D,발달상권,2120156,4331,1994,2337
2021,4,D,발달상권,2120155,2254,1083,1171
2021,4,D,발달상권,2120154,655,291,364
2021,4,D,발달상권,2120153,2370,1208,1162
2021,4,D,발달상권,2120152,2821,1258,1563
2021,4,D,발달상권,2120151,5056,2353,2703
2021,4,D,발달상권,2120150,312,140,172
2021,4,D,발달상권,2120149,2805,1333,1472
2021,4,D,발달상권,2120148,2445,1145,1300
2021,4,D,발달상권,2120147,1412,663,749
2021,4,D,발달상권,2120146,2439,1211,1228
2021,4,D,발달상권,2120145,4753,2992,1761
2021,4,D,발달상권,2120144,1588,672,916
2021,4,D,발달상권,2120143,3447,1442,2005
2021,4,D,발달상권,2120142,1324,742,582
2021,4,D,발달상권,2120141,1335,649,686
2021,4,D,발달상권,2120140,1154,572,582
2021,4,D,발달상권,2120139,2313,1207,1106
2021,4,D,발달상권,2120138,1775,843,932
2021,4,D,발달상권,2120136,3021,1568,1453
2021,4,D,발달상권,2120135,511,246,265
2021,4,D,발달상권,2120134,3455,1753,1702
2021,4,D,발달상권,2120133,465,232,233
2021,4,D,발달상권,2120132,6630,3819,2811
2021,4,D,발달상권,2120131,3865,2063,1802
2021,4,D,발달상권,2120130,2067,1156,911
2021,4,D,발달상권,2120129,8,6,2
2021,4,D,발달상권,2120128,3192,1531,1661
2021,4,D,발달상권,2120127,5465,2506,2959
2021,4,D,발달상권,2120126,599,352,247
2021,4,D,발달상권,2120125,2166,1119,1047
2021,4,D,발달상권,2120124,3695,1803,1892
2021,4,D,발달상권,2120123,5234,2395,2839
2021,4,D,발달상권,2120122,6458,2898,3560
2021,4,D,발달상권,2120121,2936,1329,1607
2021,4,D,발달상권,2120120,2748,1284,1464
2021,4,D,발달상권,2120119,2329,974,1355
2021,4,D,발달상권,2120118,1725,735,990
2021,4,D,발달상권,2120117,27,17,10
2021,4,D,발달상권,2120116,861,436,425
2021,4,D,발달상권,2120114,10743,5121,5622
2021,4,D,발달상권,2120113,3255,1558,1697
2021,4,D,발달상권,2120112,4543,2031,2512
2021,4,D,발달상권,2120111,2454,1234,1220
2021,4,D,발달상권,2120110,2106,1121,985
2021,4,D,발달상권,2120109,2146,1071,1075
2021,4,D,발달상권,2120108,3392,1673,1719
2021,4,D,발달상권,2120107,3047,1353,1694
2021,4,D,발달상권,2120106,3482,1552,1930
2021,4,D,발달상권,2120105,1351,591,760
2021,4,D,발달상권,2120104,7337,3503,3834
2021,4,D,발달상권,2120103,4789,2137,2652
2021,4,D,발달상권,2120102,3165,1497,1668
2021,4,D,발달상권,2120101,6927,3231,3696
2021,4,D,발달상권,2120100,1444,677,767
2021,4,D,발달상권,2120098,1285,501,784
2021,4,D,발달상권,2120097,873,324,549
2021,4,D,발달상권,2120096,1921,605,1316
2021,4,D,발달상권,2120095,1440,674,766
2021,4,D,발달상권,2120094,3801,1892,1909
2021,4,D,발달상권,2120093,1107,520,587
2021,4,D,발달상권,2120092,1284,614,670
2021,4,D,발달상권,2120091,3435,1517,1918
2021,4,D,발달상권,2120090,2655,1203,1452
2021,4,D,발달상권,2120089,1577,718,859
2021,4,D,발달상권,2120088,1660,758,902
2021,4,D,발달상권,2120087,2369,1062,1307
2021,4,D,발달상권,2120086,1636,778,858
2021,4,D,발달상권,2120085,191,89,102
2021,4,D,발달상권,2120084,1553,789,764
2021,4,D,발달상권,2120083,1535,719,816
2021,4,D,발달상권,2120082,80,31,49
2021,4,D,발달상권,2120081,1060,611,449
2021,4,D,발달상권,2120080,3,2,1
2021,4,D,발달상권,2120079,517,317,200
2021,4,D,발달상권,2120078,528,258,270
2021,4,D,발달상권,2120077,1777,907,870
2021,4,D,발달상권,2120076,5568,2840,2728
2021,4,D,발달상권,2120075,2238,1019,1219
2021,4,D,발달상권,2120074,420,187,233
2021,4,D,발달상권,2120073,732,342,390
2021,4,D,발달상권,2120072,3093,1168,1925
2021,4,D,발달상권,2120071,1059,457,602
2021,4,D,발달상권,2120070,1072,508,564
2021,4,D,발달상권,2120069,6181,2857,3324
2021,4,D,발달상권,2120068,706,362,344
2021,4,D,발달상권,2120067,6049,3041,3008
2021,4,D,발달상권,2120066,4543,2353,2190
2021,4,D,발달상권,2120065,2091,940,1151
2021,4,D,발달상권,2120064,761,359,402
2021,4,D,발달상권,2120063,1133,657,476
2021,4,D,발달상권,2120062,3583,1832,1751
2021,4,D,발달상권,2120061,234,99,135
2021,4,D,발달상권,2120060,5,4,1
2021,4,D,발달상권,2120059,4414,2101,2313
2021,4,D,발달상권,2120058,1867,938,929
2021,4,D,발달상권,2120057,3492,1639,1853
2021,4,D,발달상권,2120056,4755,2159,2596
2021,4,D,발달상권,2120055,6446,2864,3582
2021,4,D,발달상권,2120054,3857,1776,2081
2021,4,D,발달상권,2120053,3961,1840,2121
2021,4,D,발달상권,2120052,1062,596,466
2021,4,D,발달상권,2120051,1959,976,983
2021,4,D,발달상권,2120050,884,435,449
2021,4,D,발달상권,2120049,2136,1003,1133
2021,4,D,발달상권,2120048,1469,733,736
2021,4,D,발달상권,2120047,1746,794,952
2021,4,D,발달상권,2120046,2520,1281,1239
2021,4,D,발달상권,2120045,634,408,226
2021,4,D,발달상권,2120044,1500,768,732
2021,4,D,발달상권,2120043,450,386,64
2021,4,D,발달상권,2120042,316,158,158
2021,4,D,발달상권,2120041,7181,3369,3812
2021,4,D,발달상권,2120040,1472,829,643
2021,4,D,발달상권,2120039,3396,1666,1730
2021,4,D,발달상권,2120038,1998,939,1059
2021,4,D,발달상권,2120037,2050,1066,984
2021,4,D,발달상권,2120036,296,155,141
2021,4,D,발달상권,2120035,389,215,174
2021,4,D,발달상권,2120034,1252,635,617
2021,4,D,발달상권,2120033,84,50,34
2021,4,D,발달상권,2120032,2576,1347,1229
2021,4,D,발달상권,2120031,670,395,275
2021,4,D,발달상권,2120030,428,239,189
2021,4,D,발달상권,2120029,14,9,5
2021,4,D,발달상권,2120028,161,103,58
2021,4,D,발달상권,2120027,1216,577,639
2021,4,D,발달상권,2120026,66,38,28
2021,4,D,발달상권,2120024,1667,832,835
2021,4,D,발달상권,2120023,19,10,9
2021,4,D,발달상권,2120022,258,171,87
2021,4,D,발달상권,2120021,347,187,160
2021,4,D,발달상권,2120020,17,8,9
2021,4,D,발달상권,2120019,324,143,181
2021,4,D,발달상권,2120018,1546,896,650
2021,4,D,발달상권,2120017,867,434,433
2021,4,D,발달상권,2120016,626,445,181
2021,4,D,발달상권,2120015,145,84,61
2021,4,D,발달상권,2120014,1017,558,459
2021,4,D,발달상권,2120013,830,413,417
2021,4,D,발달상권,2120012,2001,942,1059
2021,4,D,발달상권,2120011,937,464,473
2021,4,D,발달상권,2120010,814,416,398
2021,4,D,발달상권,2120009,3708,2480,1228
2021,4,D,발달상권,2120008,397,219,178
2021,4,D,발달상권,2120007,1558,692,866
2021,4,D,발달상권,2120006,431,279,152
2021,4,D,발달상권,2120005,1159,559,600
2021,4,D,발달상권,2120004,456,231,225
2021,4,D,발달상권,2120003,3046,1330,1716
2021,4,D,발달상권,2120002,1702,790,912
2021,4,D,발달상권,2120001,708,441,267
2021,4,A,골목상권,2111090,1002,537,465
2021,4,A,골목상권,2111089,3663,1871,1792
2021,4,A,골목상권,2111088,1940,1001,939
2021,4,A,골목상권,2111087,2415,1285,1130
2021,4,A,골목상권,2111086,2403,1173,1230
2021,4,A,골목상권,2111085,4731,2486,2245
2021,4,A,골목상권,2111084,1001,483,518
2021,4,A,골목상권,2111083,3217,1578,1639
2021,4,A,골목상권,2111082,1135,546,589
2021,4,A,골목상권,2111081,258,113,145
2021,4,A,골목상권,2111080,2995,1448,1547
2021,4,A,골목상권,2111079,2026,993,1033
2021,4,A,골목상권,2111078,9203,4520,4683
2021,4,A,골목상권,2111077,11826,5846,5980
2021,4,A,골목상권,2111076,1933,969,964
2021,4,A,골목상권,2111075,4105,2056,2049
2021,4,A,골목상권,2111074,2361,1151,1210
2021,4,A,골목상권,2111073,7108,3505,3603
2021,4,A,골목상권,2111072,7277,3588,3689
2021,4,A,골목상권,2111071,1313,666,647
2021,4,A,골목상권,2111070,2820,1367,1453
2021,4,A,골목상권,2111069,5367,2708,2659
2021,4,A,골목상권,2111068,351,165,186
2021,4,A,골목상권,2111067,9414,4553,4861
2021,4,A,골목상권,2111066,5094,2529,2565
2021,4,A,골목상권,2111065,2379,1228,1151
2021,4,A,골목상권,2111064,2827,1390,1437
2021,4,A,골목상권,2111063,5811,2877,2934
2021,4,A,골목상권,2111062,3665,1845,1820
2021,4,A,골목상권,2111061,9592,4706,4886
2021,4,A,골목상권,2111060,9886,4876,5010
2021,4,A,골목상권,2111059,11543,5737,5806
2021,4,A,골목상권,2111058,1575,787,788
2021,4,A,골목상권,2111057,4229,2135,2094
2021,4,A,골목상권,2111056,802,306,496
2021,4,A,골목상권,2111055,105,54,51
2021,4,A,골목상권,2111054,441,216,225
2021,4,A,골목상권,2111053,4587,2229,2358
2021,4,A,골목상권,2111052,6010,2944,3066
2021,4,A,골목상권,2111051,6821,3263,3558
2021,4,A,골목상권,2111050,1004,473,531
2021,4,A,골목상권,2111049,4161,2074,2087
2021,4,A,골목상권,2111048,2283,1148,1135
2021,4,A,골목상권,2111047,2438,1310,1128
2021,4,A,골목상권,2111046,8910,4566,4344
2021,4,A,골목상권,2111045,2117,1093,1024
2021,4,A,골목상권,2111044,5036,2514,2522
2021,4,A,골목상권,2111043,3222,1659,1563
2021,4,A,골목상권,2111042,5596,2847,2749
2021,4,A,골목상권,2111041,1887,962,925
2021,4,A,골목상권,2111040,2343,1123,1220
2021,4,A,골목상권,2111039,2044,1026,1018
2021,4,A,골목상권,2111038,2407,1201,1206
2021,4,A,골목상권,2111037,537,282,255
2021,4,A,골목상권,2111036,1344,683,661
2021,4,A,골목상권,2111035,3928,1946,1982
2021,4,A,골목상권,2111034,4992,2415,2577
2021,4,A,골목상권,2111033,674,327,347
2021,4,A,골목상권,2111032,1729,827,902
2021,4,A,골목상권,2111031,3628,1765,1863
2021,4,A,골목상권,2111030,1884,923,961
2021,4,A,골목상권,2111029,1287,639,648
2021,4,A,골목상권,2111028,1839,936,903
2021,4,A,골목상권,2111027,5549,2738,2811
2021,4,A,골목상권,2111026,4605,2306,2299
2021,4,A,골목상권,2111025,3043,1505,1538
2021,4,A,골목상권,2111024,1531,784,747
2021,4,A,골목상권,2111023,2005,997,1008
2021,4,A,골목상권,2111022,2609,1254,1355
2021,4,A,골목상권,2111021,9954,4780,5174
2021,4,A,골목상권,2111020,685,337,348
2021,4,A,골목상권,2111019,8782,4255,4527
2021,4,A,골목상권,2111018,712,370,342
2021,4,A,골목상권,2111017,1266,587,679
2021,4,A,골목상권,2111016,3366,1570,1796
2021,4,A,골목상권,2111015,10401,4877,5524
2021,4,A,골목상권,2111014,3398,1645,1753
2021,4,A,골목상권,2111013,8690,4043,4647
2021,4,A,골목상권,2111012,6262,3004,3258
2021,4,A,골목상권,2111011,301,150,151
2021,4,A,골목상권,2111010,8776,4099,4677
2021,4,A,골목상권,2111009,1001,514,487
2021,4,A,골목상권,2111008,5126,2495,2631
2021,4,A,골목상권,2111007,8330,3931,4399
2021,4,A,골목상권,2111006,8763,4032,4731
2021,4,A,골목상권,2111005,8660,4131,4529
2021,4,A,골목상권,2111004,9985,4642,5343
2021,4,A,골목상권,2111003,10773,5077,5696
2021,4,A,골목상권,2111001,1667,825,842
2021,4,A,골목상권,2111000,444,214,230
2021,4,A,골목상권,2110999,3177,1471,1706
2021,4,A,골목상권,2110998,1311,622,689
2021,4,A,골목상권,2110997,7187,3566,3621
2021,4,A,골목상권,2110996,1430,709,721
2021,4,A,골목상권,2110995,2802,1348,1454
2021,4,A,골목상권,2110994,1777,891,886
2021,4,A,골목상권,2110993,234,121,113
2021,4,A,골목상권,2110992,7894,3676,4218
2021,4,A,골목상권,2110991,330,154,176
2021,4,A,골목상권,2110990,158,73,85
2021,4,A,골목상권,2110989,1588,750,838
2021,4,A,골목상권,2110988,1289,650,639
2021,4,A,골목상권,2110987,503,236,267
2021,4,A,골목상권,2110986,724,321,403
2021,4,A,골목상권,2110985,956,448,508
2021,4,A,골목상권,2110984,4267,2104,2163
2021,4,A,골목상권,2110983,2703,1266,1437
2021,4,A,골목상권,2110982,827,387,440
2021,4,A,골목상권,2110981,2118,1057,1061
2021,4,A,골목상권,2110980,2629,1270,1359
2021,4,A,골목상권,2110979,1131,525,606
2021,4,A,골목상권,2110978,356,154,202
2021,4,A,골목상권,2110977,691,336,355
2021,4,A,골목상권,2110976,2022,876,1146
2021,4,A,골목상권,2110975,890,417,473
2021,4,A,골목상권,2110974,1513,670,843
2021,4,A,골목상권,2110973,2295,1070,1225
2021,4,A,골목상권,2110972,1921,869,1052
2021,4,A,골목상권,2110971,3870,1781,2089
2021,4,A,골목상권,2110970,1062,491,571
2021,4,A,골목상권,2110969,1202,609,593
2021,4,A,골목상권,2110968,549,253,296
2021,4,A,골목상권,2110967,1279,615,664
2021,4,A,골목상권,2110966,2864,1241,1623
2021,4,A,골목상권,2110965,2245,1052,1193
2021,4,A,골목상권,2110964,850,395,455
2021,4,A,골목상권,2110963,1684,786,898
2021,4,A,골목상권,2110962,88,45,43
2021,4,A,골목상권,2110961,2163,998,1165
2021,4,A,골목상권,2110960,727,360,367
2021,4,A,골목상권,2110959,361,168,193
2021,4,A,골목상권,2110958,861,457,404
2021,4,A,골목상권,2110957,1761,797,964
2021,4,A,골목상권,2110956,588,290,298
2021,4,A,골목상권,2110955,7089,3339,3750
2021,4,A,골목상권,2110954,448,232,216
2021,4,A,골목상권,2110953,907,399,508
2021,4,A,골목상권,2110952,868,389,479
2021,4,A,골목상권,2110951,979,442,537
2021,4,A,골목상권,2110950,839,382,457
2021,4,A,골목상권,2110949,564,275,289
2021,4,A,골목상권,2110948,88,48,40
2021,4,A,골목상권,2110947,420,213,207
2021,4,A,골목상권,2110946,125,66,59
2021,4,A,골목상권,2110945,297,153,144
2021,4,A,골목상권,2110944,667,327,340
2021,4,A,골목상권,2110943,1580,778,802
2021,4,A,골목상권,2110942,8496,4226,4270
2021,4,A,골목상권,2110941,854,439,415
2021,4,A,골목상권,2110940,1212,595,617
2021,4,A,골목상권,2110939,6075,2872,3203
2021,4,A,골목상권,2110938,817,392,425
2021,4,A,골목상권,2110937,482,234,248
2021,4,A,골목상권,2110936,885,431,454
2021,4,A,골목상권,2110935,1076,532,544
2021,4,A,골목상권,2110934,2901,1447,1454
2021,4,A,골목상권,2110933,450,234,216
2021,4,A,골목상권,2110932,652,301,351
2021,4,A,골목상권,2110931,175,86,89
2021,4,A,골목상권,2110930,2039,983,1056
2021,4,A,골목상권,2110929,4258,2079,2179
2021,4,A,골목상권,2110928,435,220,215
2021,4,A,골목상권,2110927,273,126,147
2021,4,A,골목상권,2110926,3918,1878,2040
2021,4,A,골목상권,2110925,2841,1390,1451
2021,4,A,골목상권,2110924,3019,1407,1612
2021,4,A,골목상권,2110923,463,205,258
2021,4,A,골목상권,2110922,2787,1278,1509
2021,4,A,골목상권,2110921,1261,576,685
2021,4,A,골목상권,2110920,130,67,63
2021,4,A,골목상권,2110919,3271,1546,1725
2021,4,A,골목상권,2110918,3012,1396,1616
2021,4,A,골목상권,2110917,912,420,492
2021,4,A,골목상권,2110916,3971,1824,2147
2021,4,A,골목상권,2110915,1494,705,789
2021,4,A,골목상권,2110914,359,170,189
2021,4,A,골목상권,2110913,3912,1884,2028
2021,4,A,골목상권,2110912,317,145,172
2021,4,A,골목상권,2110911,131,72,59
2021,4,A,골목상권,2110910,2365,1058,1307
2021,4,A,골목상권,2110909,778,382,396
2021,4,A,골목상권,2110908,221,108,113
2021,4,A,골목상권,2110907,3534,1626,1908
2021,4,A,골목상권,2110906,1203,516,687
2021,4,A,골목상권,2110905,3755,1731,2024
2021,4,A,골목상권,2110904,1017,456,561
2021,4,A,골목상권,2110903,4114,1903,2211
2021,4,A,골목상권,2110902,10019,4738,5281
2021,4,A,골목상권,2110901,5323,2515,2808
2021,4,A,골목상권,2110900,6543,3306,3237
2021,4,A,골목상권,2110899,3165,1518,1647
2021,4,A,골목상권,2110898,2541,1256,1285
2021,4,A,골목상권,2110897,5719,2843,2876
2021,4,A,골목상권,2110896,270,138,132
2021,4,A,골목상권,2110895,8549,4308,4241
2021,4,A,골목상권,2110894,2078,990,1088
2021,4,A,골목상권,2110893,268,134,134
2021,4,A,골목상권,2110892,11824,5740,6084
2021,4,A,골목상권,2110891,729,347,382
2021,4,A,골목상권,2110890,3328,1569,1759
2021,4,A,골목상권,2110889,2307,1143,1164
2021,4,A,골목상권,2110888,1490,742,748
2021,4,A,골목상권,2110887,2125,1351,774
2021,4,A,골목상권,2110886,3688,2375,1313
2021,4,A,골목상권,2110885,7652,3995,3657
2021,4,A,골목상권,2110884,1386,696,690
2021,4,A,골목상권,2110883,4881,2440,2441
2021,4,A,골목상권,2110882,5190,3006,2184
2021,4,A,골목상권,2110881,11292,7267,4025
2021,4,A,골목상권,2110880,1455,706,749
2021,4,A,골목상권,2110879,2001,1038,963
2021,4,A,골목상권,2110878,1769,921,848
2021,4,A,골목상권,2110877,3562,1881,1681
2021,4,A,골목상권,2110876,2734,1470,1264
2021,4,A,골목상권,2110875,3857,1902,1955
2021,4,A,골목상권,2110874,2995,1495,1500
2021,4,A,골목상권,2110873,4498,2224,2274
2021,4,A,골목상권,2110872,2420,1202,1218
2021,4,A,골목상권,2110871,2357,1169,1188
2021,4,A,골목상권,2110870,1869,925,944
2021,4,A,골목상권,2110869,11367,5868,5499
2021,4,A,골목상권,2110868,3126,1560,1566
2021,4,A,골목상권,2110867,3553,1786,1767
2021,4,A,골목상권,2110866,4713,2401,2312
2021,4,A,골목상권,2110865,9342,4644,4698
2021,4,A,골목상권,2110864,5054,2528,2526
2021,4,A,골목상권,2110863,4128,2047,2081
2021,4,A,골목상권,2110862,2335,1157,1178
2021,4,A,골목상권,2110861,7352,3722,3630
2021,4,A,골목상권,2110860,2357,1146,1211
2021,4,A,골목상권,2110859,2852,1497,1355
2021,4,A,골목상권,2110858,844,420,424
2021,4,A,골목상권,2110857,5131,2518,2613
2021,4,A,골목상권,2110856,4246,2043,2203
2021,4,A,골목상권,2110855,4616,2270,2346
2021,4,A,골목상권,2110854,2185,1104,1081
2021,4,A,골목상권,2110853,2192,1154,1038
2021,4,A,골목상권,2110852,1902,903,999
2021,4,A,골목상권,2110851,3509,1693,1816
2021,4,A,골목상권,2110850,8232,3880,4352
2021,4,A,골목상권,2110849,3100,1528,1572
2021,4,A,골목상권,2110848,4871,2347,2524
2021,4,A,골목상권,2110847,4830,2300,2530
2021,4,A,골목상권,2110846,8998,4253,4745
2021,4,A,골목상권,2110845,1686,823,863
2021,4,A,골목상권,2110844,738,345,393
2021,4,A,골목상권,2110843,1683,792,891
2021,4,A,골목상권,2110842,505,235,270
2021,4,A,골목상권,2110841,2268,1105,1163
2021,4,A,골목상권,2110840,2236,1115,1121
2021,4,A,골목상권,2110839,1914,981,933
2021,4,A,골목상권,2110838,117,65,52
2021,4,A,골목상권,2110837,4664,2226,2438
2021,4,A,골목상권,2110836,9098,4469,4629
2021,4,A,골목상권,2110835,935,426,509
2021,4,A,골목상권,2110834,1021,566,455
2021,4,A,골목상권,2110833,2686,1289,1397
2021,4,A,골목상권,2110832,2685,1406,1279
2021,4,A,골목상권,2110831,2692,1297,1395
2021,4,A,골목상권,2110830,3693,1810,1883
2021,4,A,골목상권,2110829,3351,1691,1660
2021,4,A,골목상권,2110828,6874,3521,3353
2021,4,A,골목상권,2110827,2268,1081,1187
2021,4,A,골목상권,2110826,4283,2053,2230
2021,4,A,골목상권,2110825,9035,4304,4731
2021,4,A,골목상권,2110824,631,306,325
2021,4,A,골목상권,2110823,3469,1620,1849
2021,4,A,골목상권,2110822,4780,2281,2499
2021,4,A,골목상권,2110821,5932,2870,3062
2021,4,A,골목상권,2110820,4096,2066,2030
2021,4,A,골목상권,2110819,5394,2611,2783
2021,4,A,골목상권,2110818,813,426,387
2021,4,A,골목상권,2110817,1381,763,618
2021,4,A,골목상권,2110816,1790,932,858
2021,4,A,골목상권,2110815,4923,2533,2390
2021,4,A,골목상권,2110814,3363,1704,1659
2021,4,A,골목상권,2110813,2594,1281,1313
2021,4,A,골목상권,2110812,1434,666,768
2021,4,A,골목상권,2110811,1664,815,849
2021,4,A,골목상권,2110810,3667,1803,1864
2021,4,A,골목상권,2110809,670,333,337
2021,4,A,골목상권,2110808,624,335,289
2021,4,A,골목상권,2110807,2234,1178,1056
2021,4,A,골목상권,2110806,48,48,0
2021,4,A,골목상권,2110805,768,385,383
2021,4,A,골목상권,2110804,2297,1079,1218
2021,4,A,골목상권,2110803,2768,1431,1337
2021,4,A,골목상권,2110802,1327,672,655
2021,4,A,골목상권,2110801,208,107,101
2021,4,A,골목상권,2110800,838,509,329
2021,4,A,골목상권,2110799,633,322,311
2021,4,A,골목상권,2110798,567,295,272
2021,4,A,골목상권,2110797,193,95,98
2021,4,A,골목상권,2110796,1264,681,583
2021,4,A,골목상권,2110795,1916,960,956
2021,4,A,골목상권,2110794,3131,1425,1706
2021,4,A,골목상권,2110793,1,1,0
2021,4,A,골목상권,2110792,3784,1919,1865
2021,4,A,골목상권,2110791,223,108,115
2021,4,A,골목상권,2110790,3261,1631,1630
2021,4,A,골목상권,2110789,1685,820,865
2021,4,A,골목상권,2110788,345,191,154
2021,4,A,골목상권,2110787,3238,1630,1608
2021,4,A,골목상권,2110786,2077,1047,1030
2021,4,A,골목상권,2110785,3399,1751,1648
2021,4,A,골목상권,2110784,998,493,505
2021,4,A,골목상권,2110783,772,414,358
2021,4,A,골목상권,2110782,763,381,382
2021,4,A,골목상권,2110781,3199,1570,1629
2021,4,A,골목상권,2110780,3155,1605,1550
2021,4,A,골목상권,2110779,293,149,144
2021,4,A,골목상권,2110778,3979,1978,2001
2021,4,A,골목상권,2110777,124,92,32
2021,4,A,골목상권,2110776,3337,1712,1625
2021,4,A,골목상권,2110775,915,448,467
2021,4,A,골목상권,2110774,1317,623,694
2021,4,A,골목상권,2110773,170,90,80
2021,4,A,골목상권,2110772,1203,616,587
2021,4,A,골목상권,2110771,693,339,354
2021,4,A,골목상권,2110770,1935,974,961
2021,4,A,골목상권,2110769,573,275,298
2021,4,A,골목상권,2110768,1300,638,662
2021,4,A,골목상권,2110767,1298,675,623
2021,4,A,골목상권,2110766,2335,1157,1178
2021,4,A,골목상권,2110765,116,61,55
2021,4,A,골목상권,2110764,83,43,40
2021,4,A,골목상권,2110763,1266,627,639
2021,4,A,골목상권,2110762,11098,5486,5612
2021,4,A,골목상권,2110761,22,13,9
2021,4,A,골목상권,2110760,1108,566,542
2021,4,A,골목상권,2110759,1255,677,578
2021,4,A,골목상권,2110758,1450,678,772
2021,4,A,골목상권,2110757,2162,1136,1026
2021,4,A,골목상권,2110756,2569,1239,1330
2021,4,A,골목상권,2110755,1396,702,694
2021,4,A,골목상권,2110754,5221,2565,2656
2021,4,A,골목상권,2110753,6688,3352,3336
2021,4,A,골목상권,2110752,6820,3378,3442
2021,4,A,골목상권,2110751,5406,2711,2695
2021,4,A,골목상권,2110750,5264,2629,2635
2021,4,A,골목상권,2110749,5098,2547,2551
2021,4,A,골목상권,2110748,1914,979,935
2021,4,A,골목상권,2110747,1191,594,597
2021,4,A,골목상권,2110746,1653,799,854
2021,4,A,골목상권,2110745,2946,1485,1461
2021,4,A,골목상권,2110744,8318,4160,4158
2021,4,A,골목상권,2110743,4293,2157,2136
2021,4,A,골목상권,2110742,213,115,98
2021,4,A,골목상권,2110741,3680,1858,1822
2021,4,A,골목상권,2110740,5297,2667,2630
2021,4,A,골목상권,2110739,334,174,160
2021,4,A,골목상권,2110738,3498,1770,1728
2021,4,A,골목상권,2110737,2898,1515,1383
2021,4,A,골목상권,2110736,4634,2302,2332
2021,4,A,골목상권,2110735,5377,2737,2640
2021,4,A,골목상권,2110734,347,184,163
2021,4,A,골목상권,2110733,445,193,252
2021,4,A,골목상권,2110732,3199,1712,1487
2021,4,A,골목상권,2110731,935,458,477
2021,4,A,골목상권,2110730,2867,1548,1319
2021,4,A,골목상권,2110729,3307,1914,1393
2021,4,A,골목상권,2110728,1546,848,698
2021,4,A,골목상권,2110727,1229,660,569
2021,4,A,골목상권,2110726,1686,867,819
2021,4,A,골목상권,2110725,1908,1045,863
2021,4,A,골목상권,2110724,3331,1991,1340
2021,4,A,골목상권,2110723,816,430,386
2021,4,A,골목상권,2110722,4332,2533,1799
2021,4,A,골목상권,2110721,2548,1332,1216
2021,4,A,골목상권,2110720,2265,1094,1171
2021,4,A,골목상권,2110719,551,256,295
2021,4,A,골목상권,2110718,2665,1232,1433
2021,4,A,골목상권,2110717,7317,3743,3574
2021,4,A,골목상권,2110716,823,391,432
2021,4,A,골목상권,2110715,991,512,479
2021,4,A,골목상권,2110714,4266,2124,2142
2021,4,A,골목상권,2110713,7071,3487,3584
2021,4,A,골목상권,2110712,5072,2530,2542
2021,4,A,골목상권,2110711,3879,1911,1968
2021,4,A,골목상권,2110710,5368,2780,2588
2021,4,A,골목상권,2110709,2542,1311,1231
2021,4,A,골목상권,2110708,1126,585,541
2021,4,A,골목상권,2110707,2099,1112,987
2021,4,A,골목상권,2110706,875,453,422
2021,4,A,골목상권,2110705,158,88,70
2021,4,A,골목상권,2110704,94,68,26
2021,4,A,골목상권,2110703,2256,1114,1142
2021,4,A,골목상권,2110702,2513,1202,1311
2021,4,A,골목상권,2110701,1217,551,666
2021,4,A,골목상권,2110700,3383,1716,1667
2021,4,A,골목상권,2110699,1800,913,887
2021,4,A,골목상권,2110698,6725,3267,3458
2021,4,A,골목상권,2110697,3092,1544,1548
2021,4,A,골목상권,2110696,3589,1820,1769
2021,4,A,골목상권,2110695,5761,2936,2825
2021,4,A,골목상권,2110694,7170,3588,3582
2021,4,A,골목상권,2110693,719,396,323
2021,4,A,골목상권,2110692,2116,1104,1012
2021,4,A,골목상권,2110691,2937,1486,1451
2021,4,A,골목상권,2110690,5485,2683,2802
2021,4,A,골목상권,2110689,2950,1497,1453
2021,4,A,골목상권,2110688,2942,1447,1495
2021,4,A,골목상권,2110687,542,248,294
2021,4,A,골목상권,2110686,5134,2481,2653
2021,4,A,골목상권,2110685,781,382,399
2021,4,A,골목상권,2110684,1775,851,924
2021,4,A,골목상권,2110683,2405,1193,1212
2021,4,A,골목상권,2110682,1739,858,881
2021,4,A,골목상권,2110681,384,217,167
2021,4,A,골목상권,2110680,2486,1232,1254
2021,4,A,골목상권,2110679,1017,456,561
2021,4,A,골목상권,2110678,1094,530,564
2021,4,A,골목상권,2110677,1606,739,867
2021,4,A,골목상권,2110676,3421,1624,1797
2021,4,A,골목상권,2110675,7998,3880,4118
2021,4,A,골목상권,2110674,161,77,84
2021,4,A,골목상권,2110673,4156,2076,2080
2021,4,A,골목상권,2110672,3561,1769,1792
2021,4,A,골목상권,2110671,8100,3904,4196
2021,4,A,골목상권,2110670,7690,3764,3926
2021,4,A,골목상권,2110669,966,453,513
2021,4,A,골목상권,2110668,8784,4211,4573
2021,4,A,골목상권,2110667,640,283,357
2021,4,A,골목상권,2110666,1941,1003,938
2021,4,A,골목상권,2110665,5173,2531,2642
2021,4,A,골목상권,2110664,524,263,261
2021,4,A,골목상권,2110663,1849,914,935
2021,4,A,골목상권,2110662,12458,5948,6510
2021,4,A,골목상권,2110661,1446,723,723
2021,4,A,골목상권,2110660,1701,847,854
2021,4,A,골목상권,2110659,19671,9589,10082
2021,4,A,골목상권,2110658,3078,1583,1495
2021,4,A,골목상권,2110657,1567,719,848
2021,4,A,골목상권,2110656,9780,4911,4869
2021,4,A,골목상권,2110655,915,449,466
2021,4,A,골목상권,2110654,12359,6039,6320
2021,4,A,골목상권,2110653,2655,1276,1379
2021,4,A,골목상권,2110652,2053,1005,1048
2021,4,A,골목상권,2110651,6123,2977,3146
2021,4,A,골목상권,2110650,952,444,508
2021,4,A,골목상권,2110649,3381,1562,1819
2021,4,A,골목상권,2110648,3992,1656,2336
2021,4,A,골목상권,2110647,8529,4130,4399
2021,4,A,골목상권,2110646,8394,4043,4351
2021,4,A,골목상권,2110645,7605,3540,4065
2021,4,A,골목상권,2110644,876,444,432
2021,4,A,골목상권,2110643,2288,1187,1101
2021,4,A,골목상권,2110642,794,400,394
2021,4,A,골목상권,2110641,1562,790,772
2021,4,A,골목상권,2110640,2733,1406,1327
2021,4,A,골목상권,2110639,2745,1383,1362
2021,4,A,골목상권,2110638,5721,2872,2849
2021,4,A,골목상권,2110637,1912,960,952
2021,4,A,골목상권,2110636,1260,652,608
2021,4,A,골목상권,2110635,2974,1493,1481
2021,4,A,골목상권,2110634,8416,4385,4031
2021,4,A,골목상권,2110633,460,235,225
2021,4,A,골목상권,2110632,1526,765,761
2021,4,A,골목상권,2110631,4015,1986,2029
2021,4,A,골목상권,2110630,6024,3004,3020
2021,4,A,골목상권,2110629,906,445,461
2021,4,A,골목상권,2110628,1516,766,750
2021,4,A,골목상권,2110627,2403,1169,1234
2021,4,A,골목상권,2110626,6335,2999,3336
2021,4,A,골목상권,2110625,3327,1639,1688
2021,4,A,골목상권,2110624,2337,1133,1204
2021,4,A,골목상권,2110623,29,14,15
2021,4,A,골목상권,2110622,3971,1901,2070
2021,4,A,골목상권,2110621,663,303,360
2021,4,A,골목상권,2110620,8574,4156,4418
2021,4,A,골목상권,2110619,1379,674,705
2021,4,A,골목상권,2110618,6189,3008,3181
2021,4,A,골목상권,2110617,2541,1152,1389
2021,4,A,골목상권,2110616,838,392,446
2021,4,A,골목상권,2110615,1015,488,527
2021,4,A,골목상권,2110614,2256,1083,1173
2021,4,A,골목상권,2110613,532,254,278
2021,4,A,골목상권,2110612,8279,4104,4175
2021,4,A,골목상권,2110611,4973,2484,2489
2021,4,A,골목상권,2110610,2915,1486,1429
2021,4,A,골목상권,2110609,2412,1156,1256
2021,4,A,골목상권,2110608,8506,4183,4323
2021,4,A,골목상권,2110607,902,438,464
2021,4,A,골목상권,2110606,7118,3466,3652
2021,4,A,골목상권,2110605,1104,535,569
2021,4,A,골목상권,2110604,7013,3478,3535
2021,4,A,골목상권,2110603,313,148,165
2021,4,A,골목상권,2110602,1234,606,628
2021,4,A,골목상권,2110601,6643,3416,3227
2021,4,A,골목상권,2110600,4720,2322,2398
2021,4,A,골목상권,2110599,4226,2151,2075
2021,4,A,골목상권,2110598,3797,1825,1972
2021,4,A,골목상권,2110597,6200,3206,2994
2021,4,A,골목상권,2110596,3717,1829,1888
2021,4,A,골목상권,2110595,5725,2850,2875
2021,4,A,골목상권,2110594,3653,1787,1866
2021,4,A,골목상권,2110593,6489,3556,2933
2021,4,A,골목상권,2110592,1518,753,765
2021,4,A,골목상권,2110591,2292,1187,1105
2021,4,A,골목상권,2110590,2379,1163,1216
2021,4,A,골목상권,2110589,1737,860,877
2021,4,A,골목상권,2110588,2908,1378,1530
2021,4,A,골목상권,2110587,3370,1402,1968
2021,4,A,골목상권,2110586,1517,732,785
2021,4,A,골목상권,2110585,398,188,210
2021,4,A,골목상권,2110584,57,25,32
2021,4,A,골목상권,2110583,176,81,95
2021,4,A,골목상권,2110582,1393,675,718
2021,4,A,골목상권,2110581,292,143,149
2021,4,A,골목상권,2110580,1267,634,633
2021,4,A,골목상권,2110579,840,441,399
2021,4,A,골목상권,2110578,2721,1346,1375
2021,4,A,골목상권,2110577,946,441,505
2021,4,A,골목상권,2110576,1118,567,551
2021,4,A,골목상권,2110575,2466,1212,1254
2021,4,A,골목상권,2110574,162,92,70
2021,4,A,골목상권,2110573,451,237,214
2021,4,A,골목상권,2110572,2848,1525,1323
2021,4,A,골목상권,2110571,2382,1160,1222
2021,4,A,골목상권,2110570,878,431,447
2021,4,A,골목상권,2110569,1907,914,993
2021,4,A,골목상권,2110568,329,175,154
2021,4,A,골목상권,2110567,301,145,156
2021,4,A,골목상권,2110566,1846,859,987
2021,4,A,골목상권,2110565,1445,725,720
2021,4,A,골목상권,2110564,571,250,321
2021,4,A,골목상권,2110563,725,343,382
2021,4,A,골목상권,2110562,2902,1360,1542
2021,4,A,골목상권,2110561,2175,1036,1139
2021,4,A,골목상권,2110560,1546,739,807
2021,4,A,골목상권,2110559,2482,1154,1328
2021,4,A,골목상권,2110558,8551,4067,4484
2021,4,A,골목상권,2110557,3220,1462,1758
2021,4,A,골목상권,2110556,968,458,510
2021,4,A,골목상권,2110555,362,165,197
2021,4,A,골목상권,2110554,4013,1797,2216
2021,4,A,골목상권,2110553,3290,1623,1667
2021,4,A,골목상권,2110552,2773,1312,1461
2021,4,A,골목상권,2110551,4111,1881,2230
2021,4,A,골목상권,2110550,5796,2583,3213
2021,4,A,골목상권,2110549,2684,1285,1399
2021,4,A,골목상권,2110548,2724,1252,1472
2021,4,A,골목상권,2110547,2288,1077,1211
2021,4,A,골목상권,2110546,2376,1143,1233
2021,4,A,골목상권,2110545,5275,1796,3479
2021,4,A,골목상권,2110544,12772,5910,6862
2021,4,A,골목상권,2110543,994,493,501
2021,4,A,골목상권,2110542,5459,2594,2865
2021,4,A,골목상권,2110541,4713,2195,2518
2021,4,A,골목상권,2110540,2699,1335,1364
2021,4,A,골목상권,2110539,460,238,222
2021,4,A,골목상권,2110538,406,183,223
2021,4,A,골목상권,2110537,1057,478,579
2021,4,A,골목상권,2110536,690,350,340
2021,4,A,골목상권,2110535,1584,729,855
2021,4,A,골목상권,2110534,1476,718,758
2021,4,A,골목상권,2110533,1093,574,519
2021,4,A,골목상권,2110532,2101,1013,1088
2021,4,A,골목상권,2110531,388,186,202
2021,4,A,골목상권,2110530,247,128,119
2021,4,A,골목상권,2110529,3360,1598,1762
2021,4,A,골목상권,2110528,1526,749,777
2021,4,A,골목상권,2110527,1923,914,1009
2021,4,A,골목상권,2110526,1301,526,775
2021,4,A,골목상권,2110525,330,159,171
2021,4,A,골목상권,2110524,262,115,147
2021,4,A,골목상권,2110523,756,358,398
2021,4,A,골목상권,2110522,1431,673,758
2021,4,A,골목상권,2110521,886,416,470
2021,4,A,골목상권,2110520,1446,685,761
2021,4,A,골목상권,2110519,4412,1990,2422
2021,4,A,골목상권,2110518,704,319,385
2021,4,A,골목상권,2110517,983,448,535
2021,4,A,골목상권,2110516,1606,752,854
2021,4,A,골목상권,2110515,3226,1560,1666
2021,4,A,골목상권,2110514,2037,1072,965
2021,4,A,골목상권,2110513,991,455,536
2021,4,A,골목상권,2110512,3703,1744,1959
2021,4,A,골목상권,2110511,5564,2983,2581
2021,4,A,골목상권,2110510,1491,726,765
2021,4,A,골목상권,2110509,3601,1820,1781
2021,4,A,골목상권,2110508,2474,1145,1329
2021,4,A,골목상권,2110507,6438,3076,3362
2021,4,A,골목상권,2110506,538,254,284
2021,4,A,골목상권,2110505,150,78,72
2021,4,A,골목상권,2110504,223,112,111
2021,4,A,골목상권,2110503,5025,2521,2504
2021,4,A,골목상권,2110502,3810,1840,1970
2021,4,A,골목상권,2110501,1319,633,686
2021,4,A,골목상권,2110500,706,348,358
2021,4,A,골목상권,2110499,6065,2991,3074
2021,4,A,골목상권,2110498,3548,1742,1806
2021,4,A,골목상권,2110497,179,99,80
2021,4,A,골목상권,2110496,2057,983,1074
2021,4,A,골목상권,2110495,6253,3030,3223
2021,4,A,골목상권,2110494,814,401,413
2021,4,A,골목상권,2110493,1328,638,690
2021,4,A,골목상권,2110492,590,303,287
2021,4,A,골목상권,2110491,1899,940,959
2021,4,A,골목상권,2110490,4913,2377,2536
2021,4,A,골목상권,2110489,1305,602,703
2021,4,A,골목상권,2110488,3049,1461,1588
2021,4,A,골목상권,2110487,236,117,119
2021,4,A,골목상권,2110486,2247,1062,1185
2021,4,A,골목상권,2110485,2687,1268,1419
2021,4,A,골목상권,2110484,8031,3901,4130
2021,4,A,골목상권,2110483,3306,1550,1756
2021,4,A,골목상권,2110482,1854,893,961
2021,4,A,골목상권,2110481,2801,1318,1483
2021,4,A,골목상권,2110480,3087,1480,1607
2021,4,A,골목상권,2110479,3487,1695,1792
2021,4,A,골목상권,2110478,3230,1560,1670
2021,4,A,골목상권,2110477,3006,1422,1584
2021,4,A,골목상권,2110476,1130,529,601
2021,4,A,골목상권,2110475,3126,1501,1625
2021,4,A,골목상권,2110474,4779,2347,2432
2021,4,A,골목상권,2110473,9727,4573,5154
2021,4,A,골목상권,2110472,5462,2569,2893
2021,4,A,골목상권,2110471,4802,2365,2437
2021,4,A,골목상권,2110470,2263,1046,1217
2021,4,A,골목상권,2110469,6997,3495,3502
2021,4,A,골목상권,2110468,11068,5178,5890
2021,4,A,골목상권,2110467,1312,624,688
2021,4,A,골목상권,2110466,3972,1853,2119
2021,4,A,골목상권,2110465,2624,1231,1393
2021,4,A,골목상권,2110464,4286,2019,2267
2021,4,A,골목상권,2110463,2140,1021,1119
2021,4,A,골목상권,2110462,5978,2934,3044
2021,4,A,골목상권,2110461,1694,796,898
2021,4,A,골목상권,2110460,5480,2574,2906
2021,4,A,골목상권,2110459,4830,2259,2571
2021,4,A,골목상권,2110458,5581,2642,2939
2021,4,A,골목상권,2110457,4504,2087,2417
2021,4,A,골목상권,2110456,8202,3886,4316
2021,4,A,골목상권,2110455,8375,3938,4437
2021,4,A,골목상권,2110454,5857,2753,3104
2021,4,A,골목상권,2110453,8153,3947,4206
2021,4,A,골목상권,2110452,3166,1567,1599
2021,4,A,골목상권,2110451,5915,2908,3007
2021,4,A,골목상권,2110450,8464,4026,4438
2021,4,A,골목상권,2110449,5166,2460,2706
2021,4,A,골목상권,2110448,2604,1307,1297
2021,4,A,골목상권,2110447,1640,764,876
2021,4,A,골목상권,2110446,1879,914,965
2021,4,A,골목상권,2110445,1559,757,802
2021,4,A,골목상권,2110444,481,226,255
2021,4,A,골목상권,2110442,384,98,286
2021,4,A,골목상권,2110441,2906,1413,1493
2021,4,A,골목상권,2110440,1647,853,794
2021,4,A,골목상권,2110439,3790,1869,1921
2021,4,A,골목상권,2110438,3505,1895,1610
2021,4,A,골목상권,2110437,1654,838,816
2021,4,A,골목상권,2110436,1595,792,803
2021,4,A,골목상권,2110435,291,149,142
2021,4,A,골목상권,2110434,1600,792,808
2021,4,A,골목상권,2110433,4310,2229,2081
2021,4,A,골목상권,2110432,1906,973,933
2021,4,A,골목상권,2110431,922,502,420
2021,4,A,골목상권,2110430,133,66,67
2021,4,A,골목상권,2110429,4828,2351,2477
2021,4,A,골목상권,2110428,8437,4198,4239
2021,4,A,골목상권,2110427,599,297,302
2021,4,A,골목상권,2110426,4097,2058,2039
2021,4,A,골목상권,2110425,3393,1701,1692
2021,4,A,골목상권,2110424,2879,1452,1427
2021,4,A,골목상권,2110423,445,236,209
2021,4,A,골목상권,2110422,920,439,481
2021,4,A,골목상권,2110421,1266,673,593
2021,4,A,골목상권,2110420,1548,903,645
2021,4,A,골목상권,2110419,3088,1524,1564
2021,4,A,골목상권,2110418,1447,802,645
2021,4,A,골목상권,2110417,1077,558,519
2021,4,A,골목상권,2110416,2453,1168,1285
2021,4,A,골목상권,2110415,5054,2558,2496
2021,4,A,골목상권,2110414,670,341,329
2021,4,A,골목상권,2110413,1963,922,1041
2021,4,A,골목상권,2110412,379,188,191
2021,4,A,골목상권,2110411,1537,784,753
2021,4,A,골목상권,2110410,2564,1331,1233
2021,4,A,골목상권,2110409,2744,1326,1418
2021,4,A,골목상권,2110408,1311,612,699
2021,4,A,골목상권,2110407,6670,3444,3226
2021,4,A,골목상권,2110406,1639,837,802
2021,4,A,골목상권,2110405,6862,3488,3374
2021,4,A,골목상권,2110404,10362,5208,5154
2021,4,A,골목상권,2110403,6009,3011,2998
2021,4,A,골목상권,2110402,3094,1544,1550
2021,4,A,골목상권,2110401,588,294,294
2021,4,A,골목상권,2110400,4057,2016,2041
2021,4,A,골목상권,2110399,8173,3918,4255
2021,4,A,골목상권,2110398,2979,1438,1541
2021,4,A,골목상권,2110397,7559,3803,3756
2021,4,A,골목상권,2110396,1982,965,1017
2021,4,A,골목상권,2110395,1363,676,687
2021,4,A,골목상권,2110394,7089,3593,3496
2021,4,A,골목상권,2110393,211,108,103
2021,4,A,골목상권,2110392,139,63,76
2021,4,A,골목상권,2110391,5500,2785,2715
2021,4,A,골목상권,2110390,1725,823,902
2021,4,A,골목상권,2110389,1166,599,567
2021,4,A,골목상권,2110388,2541,1205,1336
2021,4,A,골목상권,2110387,5312,2551,2761
2021,4,A,골목상권,2110386,356,163,193
2021,4,A,골목상권,2110385,1690,821,869
2021,4,A,골목상권,2110384,1316,648,668
2021,4,A,골목상권,2110383,673,277,396
2021,4,A,골목상권,2110382,811,385,426
2021,4,A,골목상권,2110381,580,277,303
2021,4,A,골목상권,2110380,2345,1114,1231
2021,4,A,골목상권,2110379,961,506,455
2021,4,A,골목상권,2110378,1802,884,918
2021,4,A,골목상권,2110377,838,424,414
2021,4,A,골목상권,2110376,7975,4020,3955
2021,4,A,골목상권,2110375,2757,1371,1386
2021,4,A,골목상권,2110374,5539,2661,2878
2021,4,A,골목상권,2110373,3416,1677,1739
2021,4,A,골목상권,2110372,2880,1383,1497
2021,4,A,골목상권,2110371,1633,845,788
2021,4,A,골목상권,2110370,2982,1483,1499
2021,4,A,골목상권,2110369,4526,2124,2402
2021,4,A,골목상권,2110368,3562,1788,1774
2021,4,A,골목상권,2110367,1842,873,969
2021,4,A,골목상권,2110366,2047,1045,1002
2021,4,A,골목상권,2110365,4824,2318,2506
2021,4,A,골목상권,2110364,4359,2127,2232
2021,4,A,골목상권,2110363,1003,485,518
2021,4,A,골목상권,2110362,5561,2674,2887
2021,4,A,골목상권,2110361,2532,1277,1255
2021,4,A,골목상권,2110360,4037,1991,2046
2021,4,A,골목상권,2110359,6161,3006,3155
2021,4,A,골목상권,2110358,3705,1823,1882
2021,4,A,골목상권,2110357,1275,632,643
2021,4,A,골목상권,2110356,3376,1598,1778
2021,4,A,골목상권,2110355,3076,1545,1531
2021,4,A,골목상권,2110354,421,213,208
2021,4,A,골목상권,2110353,2210,1061,1149
2021,4,A,골목상권,2110352,5164,2550,2614
2021,4,A,골목상권,2110351,3257,1546,1711
2021,4,A,골목상권,2110350,2831,1390,1441
2021,4,A,골목상권,2110349,1123,536,587
2021,4,A,골목상권,2110348,3968,1902,2066
2021,4,A,골목상권,2110347,1343,670,673
2021,4,A,골목상권,2110346,1212,572,640
2021,4,A,골목상권,2110345,3055,1487,1568
2021,4,A,골목상권,2110344,1076,555,521
2021,4,A,골목상권,2110343,4670,2290,2380
2021,4,A,골목상권,2110342,2643,1267,1376
2021,4,A,골목상권,2110341,2018,970,1048
2021,4,A,골목상권,2110340,1432,704,728
2021,4,A,골목상권,2110339,335,157,178
2021,4,A,골목상권,2110338,1226,614,612
2021,4,A,골목상권,2110337,2920,1425,1495
2021,4,A,골목상권,2110336,2302,1156,1146
2021,4,A,골목상권,2110335,4363,2191,2172
2021,4,A,골목상권,2110334,2693,1370,1323
2021,4,A,골목상권,2110333,1338,661,677
2021,4,A,골목상권,2110332,875,481,394
2021,4,A,골목상권,2110331,3201,1559,1642
2021,4,A,골목상권,2110330,2041,1012,1029
2021,4,A,골목상권,2110329,2466,1223,1243
2021,4,A,골목상권,2110328,2457,1238,1219
2021,4,A,골목상권,2110327,3362,1683,1679
2021,4,A,골목상권,2110326,1353,653,700
2021,4,A,골목상권,2110325,3601,1774,1827
2021,4,A,골목상권,2110324,401,205,196
2021,4,A,골목상권,2110323,2214,965,1249
2021,4,A,골목상권,2110322,2953,1362,1591
2021,4,A,골목상권,2110321,696,305,391
2021,4,A,골목상권,2110320,810,422,388
2021,4,A,골목상권,2110319,3212,1479,1733
2021,4,A,골목상권,2110318,1844,946,898
2021,4,A,골목상권,2110317,2575,1408,1167
2021,4,A,골목상권,2110316,5093,2513,2580
2021,4,A,골목상권,2110315,3029,1467,1562
2021,4,A,골목상권,2110314,1089,563,526
2021,4,A,골목상권,2110313,1359,764,595
2021,4,A,골목상권,2110312,1387,706,681
2021,4,A,골목상권,2110311,1627,834,793
2021,4,A,골목상권,2110310,52,21,31
2021,4,A,골목상권,2110309,1162,600,562
2021,4,A,골목상권,2110308,985,477,508
2021,4,A,골목상권,2110307,237,121,116
2021,4,A,골목상권,2110306,1185,564,621
2021,4,A,골목상권,2110305,4013,2070,1943
2021,4,A,골목상권,2110304,1843,899,944
2021,4,A,골목상권,2110303,3213,1214,1999
2021,4,A,골목상권,2110302,2225,1068,1157
2021,4,A,골목상권,2110301,3563,1624,1939
2021,4,A,골목상권,2110300,4711,2012,2699
2021,4,A,골목상권,2110299,3021,1528,1493
2021,4,A,골목상권,2110298,659,320,339
2021,4,A,골목상권,2110297,6528,3049,3479
2021,4,A,골목상권,2110296,1878,831,1047
2021,4,A,골목상권,2110295,5041,2441,2600
2021,4,A,골목상권,2110294,6726,3300,3426
2021,4,A,골목상권,2110293,2435,1116,1319
2021,4,A,골목상권,2110292,563,263,300
2021,4,A,골목상권,2110291,4471,2132,2339
2021,4,A,골목상권,2110290,1336,685,651
2021,4,A,골목상권,2110289,5175,2561,2614
2021,4,A,골목상권,2110288,1929,899,1030
2021,4,A,골목상권,2110287,1740,885,855
2021,4,A,골목상권,2110286,2465,1134,1331
2021,4,A,골목상권,2110285,1965,939,1026
2021,4,A,골목상권,2110284,2087,1014,1073
2021,4,A,골목상권,2110283,501,209,292
2021,4,A,골목상권,2110282,1907,989,918
2021,4,A,골목상권,2110281,1055,492,563
2021,4,A,골목상권,2110280,840,400,440
2021,4,A,골목상권,2110279,49,30,19
2021,4,A,골목상권,2110278,4314,2273,2041
2021,4,A,골목상권,2110277,4237,2138,2099
2021,4,A,골목상권,2110276,541,299,242
2021,4,A,골목상권,2110275,966,507,459
2021,4,A,골목상권,2110274,7599,3869,3730
2021,4,A,골목상권,2110273,2131,1115,1016
2021,4,A,골목상권,2110272,3674,1818,1856
2021,4,A,골목상권,2110271,266,136,130
2021,4,A,골목상권,2110270,1191,581,610
2021,4,A,골목상권,2110269,1559,804,755
2021,4,A,골목상권,2110268,2776,1401,1375
2021,4,A,골목상권,2110267,4437,2168,2269
2021,4,A,골목상권,2110266,5436,2647,2789
2021,4,A,골목상권,2110265,1080,537,543
2021,4,A,골목상권,2110264,9709,4874,4835
2021,4,A,골목상권,2110263,6700,3288,3412
2021,4,A,골목상권,2110262,4603,2197,2406
2021,4,A,골목상권,2110261,4946,2476,2470
2021,4,A,골목상권,2110260,2212,1132,1080
2021,4,A,골목상권,2110259,3921,1974,1947
2021,4,A,골목상권,2110258,5895,2935,2960
2021,4,A,골목상권,2110257,4258,2142,2116
2021,4,A,골목상권,2110256,7894,3973,3921
2021,4,A,골목상권,2110255,6260,3116,3144
2021,4,A,골목상권,2110254,6869,3414,3455
2021,4,A,골목상권,2110253,3148,1607,1541
2021,4,A,골목상권,2110252,4507,2296,2211
2021,4,A,골목상권,2110251,4165,1991,2174
2021,4,A,골목상권,2110250,1484,727,757
2021,4,A,골목상권,2110249,6276,3082,3194
2021,4,A,골목상권,2110248,1606,812,794
2021,4,A,골목상권,2110247,5760,2814,2946
2021,4,A,골목상권,2110246,2897,1468,1429
2021,4,A,골목상권,2110245,2222,1143,1079
2021,4,A,골목상권,2110244,1764,911,853
2021,4,A,골목상권,2110243,4770,2389,2381
2021,4,A,골목상권,2110242,4233,2145,2088
2021,4,A,골목상권,2110241,3184,1617,1567
2021,4,A,골목상권,2110240,1282,651,631
2021,4,A,골목상권,2110239,269,149,120
2021,4,A,골목상권,2110238,1506,722,784
2021,4,A,골목상권,2110237,4316,2182,2134
2021,4,A,골목상권,2110236,8140,3995,4145
2021,4,A,골목상권,2110235,1398,762,636
2021,4,A,골목상권,2110234,781,366,415
2021,4,A,골목상권,2110233,5154,2665,2489
2021,4,A,골목상권,2110232,3310,1683,1627
2021,4,A,골목상권,2110231,240,124,116
2021,4,A,골목상권,2110230,3650,1811,1839
2021,4,A,골목상권,2110229,7371,3718,3653
2021,4,A,골목상권,2110228,5530,2789,2741
2021,4,A,골목상권,2110227,774,374,400
2021,4,A,골목상권,2110226,11156,5610,5546
2021,4,A,골목상권,2110225,1228,637,591
2021,4,A,골목상권,2110224,464,250,214
2021,4,A,골목상권,2110223,1586,818,768
2021,4,A,골목상권,2110222,3,3,0
2021,4,A,골목상권,2110221,1028,514,514
2021,4,A,골목상권,2110220,2003,1022,981
2021,4,A,골목상권,2110219,7155,3740,3415
2021,4,A,골목상권,2110218,2441,1239,1202
2021,4,A,골목상권,2110217,575,310,265
2021,4,A,골목상권,2110216,1159,582,577
2021,4,A,골목상권,2110215,2090,1007,1083
2021,4,A,골목상권,2110214,2853,1464,1389
2021,4,A,골목상권,2110213,831,405,426
2021,4,A,골목상권,2110212,2112,1082,1030
2021,4,A,골목상권,2110211,3551,1773,1778
2021,4,A,골목상권,2110210,3837,1978,1859
2021,4,A,골목상권,2110209,666,336,330
2021,4,A,골목상권,2110208,894,430,464
2021,4,A,골목상권,2110207,1028,522,506
2021,4,A,골목상권,2110206,3693,1850,1843
2021,4,A,골목상권,2110205,2672,1307,1365
2021,4,A,골목상권,2110204,3492,1721,1771
2021,4,A,골목상권,2110203,1769,905,864
2021,4,A,골목상권,2110202,1584,918,666
2021,4,A,골목상권,2110201,528,304,224
2021,4,A,골목상권,2110200,807,436,371
2021,4,A,골목상권,2110199,1064,569,495
2021,4,A,골목상권,2110198,120,62,58
2021,4,A,골목상권,2110197,548,278,270
2021,4,A,골목상권,2110196,1288,660,628
2021,4,A,골목상권,2110195,3708,1911,1797
2021,4,A,골목상권,2110194,1726,898,828
2021,4,A,골목상권,2110193,1342,699,643
2021,4,A,골목상권,2110192,605,345,260
2021,4,A,골목상권,2110191,1199,659,540
2021,4,A,골목상권,2110190,2501,1319,1182
2021,4,A,골목상권,2110189,2240,1120,1120
2021,4,A,골목상권,2110188,4502,2200,2302
2021,4,A,골목상권,2110187,4444,2136,2308
2021,4,A,골목상권,2110186,417,253,164
2021,4,A,골목상권,2110185,431,244,187
2021,4,A,골목상권,2110184,439,221,218
2021,4,A,골목상권,2110183,548,319,229
2021,4,A,골목상권,2110182,1036,614,422
2021,4,A,골목상권,2110181,1395,634,761
2021,4,A,골목상권,2110180,1576,759,817
2021,4,A,골목상권,2110179,1086,525,561
2021,4,A,골목상권,2110178,1296,628,668
2021,4,A,골목상권,2110177,1792,867,925
2021,4,A,골목상권,2110176,5870,2921,2949
2021,4,A,골목상권,2110175,5322,2502,2820
2021,4,A,골목상권,2110174,4677,2242,2435
2021,4,A,골목상권,2110173,1410,654,756
2021,4,A,골목상권,2110172,4148,2011,2137
2021,4,A,골목상권,2110171,2409,1145,1264
2021,4,A,골목상권,2110170,6046,2931,3115
2021,4,A,골목상권,2110169,2536,1265,1271
2021,4,A,골목상권,2110168,2988,1460,1528
2021,4,A,골목상권,2110167,6863,3258,3605
2021,4,A,골목상권,2110166,6101,2891,3210
2021,4,A,골목상권,2110165,4593,2230,2363
2021,4,A,골목상권,2110164,3398,1584,1814
2021,4,A,골목상권,2110163,2820,1315,1505
2021,4,A,골목상권,2110162,3621,1695,1926
2021,4,A,골목상권,2110161,4856,2405,2451
2021,4,A,골목상권,2110160,1893,905,988
2021,4,A,골목상권,2110159,9021,4311,4710
2021,4,A,골목상권,2110158,6729,3352,3377
2021,4,A,골목상권,2110157,5774,2858,2916
2021,4,A,골목상권,2110156,6487,2999,3488
2021,4,A,골목상권,2110155,4200,2072,2128
2021,4,A,골목상권,2110154,4498,2194,2304
2021,4,A,골목상권,2110153,2711,1289,1422
2021,4,A,골목상권,2110152,1856,951,905
2021,4,A,골목상권,2110151,4732,2306,2426
2021,4,A,골목상권,2110150,6333,3133,3200
2021,4,A,골목상권,2110149,1025,472,553
2021,4,A,골목상권,2110148,1537,769,768
2021,4,A,골목상권,2110147,6383,3232,3151
2021,4,A,골목상권,2110146,3659,1856,1803
2021,4,A,골목상권,2110145,836,411,425
2021,4,A,골목상권,2110144,2023,952,1071
2021,4,A,골목상권,2110143,126,65,61
2021,4,A,골목상권,2110142,6090,2933,3157
2021,4,A,골목상권,2110141,2859,1367,1492
2021,4,A,골목상권,2110140,5150,2584,2566
2021,4,A,골목상권,2110139,5303,2677,2626
2021,4,A,골목상권,2110138,3509,1882,1627
2021,4,A,골목상권,2110137,1611,857,754
2021,4,A,골목상권,2110136,2536,1316,1220
2021,4,A,골목상권,2110135,984,543,441
2021,4,A,골목상권,2110134,5509,2957,2552
2021,4,A,골목상권,2110133,1855,944,911
2021,4,A,골목상권,2110132,2091,1066,1025
2021,4,A,골목상권,2110131,2617,1404,1213
2021,4,A,골목상권,2110130,1188,587,601
2021,4,A,골목상권,2110129,1614,798,816
2021,4,A,골목상권,2110128,7437,3988,3449
2021,4,A,골목상권,2110127,980,487,493
2021,4,A,골목상권,2110126,783,370,413
2021,4,A,골목상권,2110125,4368,2252,2116
2021,4,A,골목상권,2110124,856,476,380
2021,4,A,골목상권,2110123,2756,1375,1381
2021,4,A,골목상권,2110122,905,459,446
2021,4,A,골목상권,2110121,934,555,379
2021,4,A,골목상권,2110120,798,398,400
2021,4,A,골목상권,2110119,284,141,143
2021,4,A,골목상권,2110118,1097,581,516
2021,4,A,골목상권,2110117,1595,818,777
2021,4,A,골목상권,2110116,2059,1041,1018
2021,4,A,골목상권,2110115,2063,1044,1019
2021,4,A,골목상권,2110114,883,429,454
2021,4,A,골목상권,2110113,1424,710,714
2021,4,A,골목상권,2110112,2613,1254,1359
2021,4,A,골목상권,2110111,1446,728,718
2021,4,A,골목상권,2110110,1994,931,1063
2021,4,A,골목상권,2110109,451,226,225
2021,4,A,골목상권,2110108,3,1,2
2021,4,A,골목상권,2110107,224,105,119
2021,4,A,골목상권,2110106,919,458,461
2021,4,A,골목상권,2110105,2899,1405,1494
2021,4,A,골목상권,2110104,3598,1744,1854
2021,4,A,골목상권,2110103,331,161,170
2021,4,A,골목상권,2110102,836,398,438
2021,4,A,골목상권,2110101,662,281,381
2021,4,A,골목상권,2110100,339,168,171
2021,4,A,골목상권,2110099,1823,895,928
2021,4,A,골목상권,2110098,219,104,115
2021,4,A,골목상권,2110097,391,186,205
2021,4,A,골목상권,2110096,1072,483,589
2021,4,A,골목상권,2110095,2582,1151,1431
2021,4,A,골목상권,2110094,358,183,175
2021,4,A,골목상권,2110093,5830,3026,2804
2021,4,A,골목상권,2110092,3771,1858,1913
2021,4,A,골목상권,2110091,153,75,78
2021,4,A,골목상권,2110090,1963,915,1048
2021,4,A,골목상권,2110089,2666,1298,1368
2021,4,A,골목상권,2110088,1728,851,877
2021,4,A,골목상권,2110087,1882,843,1039
2021,4,A,골목상권,2110086,1266,608,658
2021,4,A,골목상권,2110085,2745,1282,1463
2021,4,A,골목상권,2110084,3551,1592,1959
2021,4,A,골목상권,2110083,727,358,369
2021,4,A,골목상권,2110082,982,466,516
2021,4,A,골목상권,2110081,3429,1583,1846
2021,4,A,골목상권,2110080,4134,2029,2105
2021,4,A,골목상권,2110079,10480,5031,5449
2021,4,A,골목상권,2110078,465,217,248
2021,4,A,골목상권,2110077,1233,595,638
2021,4,A,골목상권,2110076,18,12,6
2021,4,A,골목상권,2110075,3263,1729,1534
2021,4,A,골목상권,2110074,3182,2085,1097
2021,4,A,골목상권,2110073,418,199,219
2021,4,A,골목상권,2110072,124,91,33
2021,4,A,골목상권,2110071,232,103,129
2021,4,A,골목상권,2110070,105,49,56
2021,4,A,골목상권,2110069,5003,1948,3055
2021,4,A,골목상권,2110068,3360,1585,1775
2021,4,A,골목상권,2110067,8305,4166,4139
2021,4,A,골목상권,2110066,2712,1376,1336
2021,4,A,골목상권,2110065,155,72,83
2021,4,A,골목상권,2110064,3112,1425,1687
2021,4,A,골목상권,2110063,2934,1472,1462
2021,4,A,골목상권,2110062,1303,685,618
2021,4,A,골목상권,2110061,3915,1842,2073
2021,4,A,골목상권,2110060,3542,1683,1859
2021,4,A,골목상권,2110059,1785,831,954
2021,4,A,골목상권,2110058,3933,1892,2041
2021,4,A,골목상권,2110057,1752,733,1019
2021,4,A,골목상권,2110056,4926,2410,2516
2021,4,A,골목상권,2110055,302,150,152
2021,4,A,골목상권,2110054,1956,936,1020
2021,4,A,골목상권,2110053,2634,1310,1324
2021,4,A,골목상권,2110052,1688,851,837
2021,4,A,골목상권,2110051,1222,640,582
2021,4,A,골목상권,2110050,835,392,443
2021,4,A,골목상권,2110049,1958,913,1045
2021,4,A,골목상권,2110048,2457,1192,1265
2021,4,A,골목상권,2110047,2754,1296,1458
2021,4,A,골목상권,2110046,4048,2032,2016
2021,4,A,골목상권,2110045,910,473,437
2021,4,A,골목상권,2110044,245,112,133
2021,4,A,골목상권,2110043,2101,1105,996
2021,4,A,골목상권,2110042,1642,829,813
2021,4,A,골목상권,2110041,701,351,350
2021,4,A,골목상권,2110040,864,410,454
2021,4,A,골목상권,2110039,87,53,34
2021,4,A,골목상권,2110038,113,83,30
2021,4,A,골목상권,2110037,1535,772,763
2021,4,A,골목상권,2110036,404,221,183
2021,4,A,골목상권,2110035,3405,1792,1613
2021,4,A,골목상권,2110034,348,200,148
2021,4,A,골목상권,2110033,1827,891,936
2021,4,A,골목상권,2110032,27,14,13
2021,4,A,골목상권,2110031,455,218,237
2021,4,A,골목상권,2110030,411,208,203
2021,4,A,골목상권,2110029,5004,2622,2382
2021,4,A,골목상권,2110028,3953,2024,1929
2021,4,A,골목상권,2110027,2842,1314,1528
2021,4,A,골목상권,2110026,108,53,55
2021,4,A,골목상권,2110025,479,262,217
2021,4,A,골목상권,2110024,1257,561,696
2021,4,A,골목상권,2110023,770,350,420
2021,4,A,골목상권,2110022,1625,734,891
2021,4,A,골목상권,2110021,2009,978,1031
2021,4,A,골목상권,2110020,4192,2125,2067
2021,4,A,골목상권,2110019,241,142,99
2021,4,A,골목상권,2110018,2850,1352,1498
2021,4,A,골목상권,2110017,747,361,386
2021,4,A,골목상권,2110016,2003,952,1051
2021,4,A,골목상권,2110015,589,279,310
2021,4,A,골목상권,2110014,931,429,502
2021,4,A,골목상권,2110013,332,156,176
2021,4,A,골목상권,2110012,1952,884,1068
2021,4,A,골목상권,2110011,538,268,270
2021,4,A,골목상권,2110010,4355,1983,2372
2021,4,A,골목상권,2110009,1755,839,916
2021,4,A,골목상권,2110008,5211,2340,2871
2021,4,A,골목상권,2110007,1972,900,1072
2021,4,A,골목상권,2110006,687,319,368
2021,4,A,골목상권,2110005,1796,858,938
2021,4,A,골목상권,2110004,471,221,250
2021,4,A,골목상권,2110003,3300,1554,1746
2021,4,A,골목상권,2110002,629,309,320
2021,4,A,골목상권,2110001,1170,546,624
