기준_년월_코드,기준_분기_코드,상권_구분_코드,상권_코드,상권_코드_명,총_직장_인구_수,남성_직장_인구_수,여성_직장_인구_수
2021,4,U,1001496,강남 마이스 관광특구,15904,8904,7000
2021,4,U,1001495,잠실 관광특구,24375,14199,10176
2021,4,U,1001494,종로?청계 관광특구,32935,17150,15785
2021,4,U,1001493,동대문패션타운 관광특구,6054,2958,3096
2021,4,U,1001492,명동 남대문 북창동 다동 무교동 관광특구,104830,53674,51156
2021,4,U,1001491,이태원 관광특구,5839,3064,2775
2021,4,R,2130326,고덕 골목형상점가,935,850,85
2021,4,R,2130325,명일전통시장,89,30,59
2021,4,R,2130324,길동복조리시장,154,85,69
2021,4,R,2130323,둔촌역전통시장,171,86,85
2021,4,R,2130322,고분다리전통시장,8,5,3
2021,4,R,2130321,장신구 특화거리 상점가,433,269,164
2021,4,R,2130320,암사종합시장,173,97,76
2021,4,R,2130319,성내전통시장,34,21,13
2021,4,R,2130318,로데오거리상점가,266,132,134
2021,4,R,2130317,마천중앙시장,107,77,30
2021,4,R,2130316,마천시장,18,9,9
2021,4,R,2130315,문정동 로데오거리 상점가(문정동 로데오거리),1372,808,564
2021,4,R,2130314,풍납시장,202,99,103
2021,4,R,2130313,방이시장,3469,1526,1943
2021,4,R,2130312,석촌시장,619,270,349
2021,4,R,2130311,새마을시장,377,246,131
2021,4,R,2130310,강남개포시장,298,173,125
2021,4,R,2130308,청담삼익시장,48,30,18
2021,4,R,2130307,도곡시장,57,25,32
2021,4,R,2130306,강남언주로,235,151,84
2021,4,R,2130305,논현종합시장,85,43,42
2021,4,R,2130304,신사상가,138,79,59
2021,4,R,2130303,영동전통시장,242,95,147
2021,4,R,2130302,강남시장(강남구 강남시장),58,33,25
2021,4,R,2130301,양재시장,35,22,13
2021,4,R,2130299,엔터식스 강남점,1850,1551,299
2021,4,R,2130298,강남터미널지하도상점가2구역,2,1,1
2021,4,R,2130296,남부종합시장,85,63,22
2021,4,R,2130295,인헌시장(원당종합시장),122,48,74
2021,4,R,2130294,관악중부시장,102,40,62
2021,4,R,2130293,봉천중앙시장,154,42,112
2021,4,R,2130290,영림시장,417,183,234
2021,4,R,2130289,봉일시장,36,20,16
2021,4,R,2130288,신림현대종합상가,2,0,2
2021,4,R,2130285,서원동상점가,615,316,299
2021,4,R,2130284,관악종합시장(신원시장),17,10,7
2021,4,R,2130283,신원시장,25,11,14
2021,4,R,2130282,난곡 골목형상점가,20,8,12
2021,4,R,2130281,우림시장,1,0,1
2021,4,R,2130280,신림종합시장,8,7,1
2021,4,R,2130279,관악신사시장,120,63,57
2021,4,R,2130278,미성동 도깨비시장 골목형상점가,75,16,59
2021,4,R,2130277,조원동 펭귄시장(신림중앙시장),98,56,42
2021,4,R,2130276,신림중앙시장(조원동 펭귄시장),43,27,16
2021,4,R,2130275,강남골목시장,168,124,44
2021,4,R,2130274,사당1동먹자골목상점가(사당1동먹자골목),389,218,171
2021,4,R,2130273,남성사계시장(남성시장),141,63,78
2021,4,R,2130272,사당시장,45,20,25
2021,4,R,2130271,남성역골목시장,467,268,199
2021,4,R,2130270,흑석시장,4,3,1
2021,4,R,2130268,상도전통시장,239,104,135
2021,4,R,2130267,본동인정시장(기능상실),59,41,18
2021,4,R,2130266,만양로상점가,129,75,54
2021,4,R,2130265,노량진중앙시장,115,82,33
2021,4,R,2130264,상도약수골목형상점가,65,35,30
2021,4,R,2130263,신노량진시장(기능상실),11,3,8
2021,4,R,2130262,상도도깨비 골목형상점가,18,8,10
2021,4,R,2130261,성대전통시장(성대시장),211,104,107
2021,4,R,2130260,신대방1동골목상권,70,31,39
2021,4,R,2130259,대신시장,12,9,3
2021,4,R,2130257,영등포시장기계공구상가,158,116,42
2021,4,R,2130256,신동시장,2,2,0
2021,4,R,2130255,영등포전통시장,45,29,16
2021,4,R,2130253,영신상가(제일상가),9,7,2
2021,4,R,2130250,삼구시장(로타리상가),1,0,1
2021,4,R,2130249,동남상가,10,8,2
2021,4,R,2130248,영등포역지하도상점가,12,5,7
2021,4,R,2130247,우리시장,21,16,5
2021,4,R,2130246,영등포청과시장(조광시장),237,126,111
2021,4,R,2130245,영일시장,675,567,108
2021,4,R,2130244,대림중앙시장,95,39,56
2021,4,R,2130243,도림시장,6,4,2
2021,4,R,2130242,대림중앙 골목형상점가,68,21,47
2021,4,R,2130241,선유도역 골목형상점가,500,253,247
2021,4,R,2130240,영등포유통상가,1183,753,430
2021,4,R,2130238,은행나무시장,113,71,42
2021,4,R,2130237,박미시장(기능상실),39,26,13
2021,4,R,2130236,비단길현대시장(현대시장),139,42,97
2021,4,R,2130235,대명여울빛거리시장(대명시장),298,80,218
2021,4,R,2130234,푸른터시장(기능상실),3,2,1
2021,4,R,2130233,남문시장,76,47,29
2021,4,R,2130232,독산동 맛나는거리상점가(독산동 맛나는거리),33,24,9
2021,4,R,2130231,독산동 우시장,611,476,135
2021,4,R,2130229,남구로시장,249,139,110
2021,4,R,2130228,구로시장,10,5,5
2021,4,R,2130227,고척골목시장상점가(그라운드 고척),97,68,29
2021,4,R,2130226,고척프라자,2,2,0
2021,4,R,2130225,개봉중앙시장,147,59,88
2021,4,R,2130224,개봉프라자(고척근린시장),5,4,1
2021,4,R,2130223,고척근린시장,42,12,30
2021,4,R,2130222,오류시장,132,21,111
2021,4,R,2130221,남부골목시장(남부화곡시장 남부시장),188,69,119
2021,4,R,2130219,까치산시장,124,37,87
2021,4,R,2130218,신월중앙시장,118,53,65
2021,4,R,2130217,화곡본동시장,36,16,20
2021,4,R,2130216,화곡중앙시장,75,32,43
2021,4,R,2130215,대원종합시장,9,7,2
2021,4,R,2130214,송화벽화시장(송화골목시장),119,44,75
2021,4,R,2130213,방신전통시장,112,77,35
2021,4,R,2130212,공항시장,8,6,2
2021,4,R,2130211,신정2동 골목시장(오목교중앙시장),51,18,33
2021,4,R,2130210,목2동시장,432,251,181
2021,4,R,2130209,목사랑시장(목4동시장),111,61,50
2021,4,R,2130208,목동깨비시장(목3동시장),148,67,81
2021,4,R,2130207,신정1동 골목시장(신정제일시장),38,21,17
2021,4,R,2130206,신정3동 골목시장,20,6,14
2021,4,R,2130205,신곡종합시장(신월6동 골목시장),141,103,38
2021,4,R,2130204,경창시장,100,50,50
2021,4,R,2130203,서서울 골목형상점가,34,7,27
2021,4,R,2130202,신영시장,40,13,27
2021,4,R,2130201,월정로시장,27,17,10
2021,4,R,2130200,신월7동 골목시장(약수시장 우성상가),27,18,9
2021,4,R,2130199,신월3동 골목시장,18,8,10
2021,4,R,2130198,아현시장,203,45,158
2021,4,R,2130197,마포시장,15,5,10
2021,4,R,2130196,공덕시장,3948,2001,1947
2021,4,R,2130195,도화동 상점가,1055,510,545
2021,4,R,2130194,용강동 상점가,875,502,373
2021,4,R,2130193,신수시장,34,19,15
2021,4,R,2130192,동진시장,10,6,4
2021,4,R,2130191,홍대 걷고싶은 거리,367,225,142
2021,4,R,2130190,홍대소상공인상점가,150,77,73
2021,4,R,2130189,서교시장,24,10,14
2021,4,R,2130187,영진시장,29,14,15
2021,4,R,2130186,망원시장,178,84,94
2021,4,R,2130185,망원월드컵시장,190,123,67
2021,4,R,2130184,마포농수산물시장,77,40,37
2021,4,R,2130183,상암동상점가,816,607,209
2021,4,R,2130182,영천시장,78,35,43
2021,4,R,2130181,아현가구거리상점가,59,30,29
2021,4,R,2130180,포방터시장,59,34,25
2021,4,R,2130179,이화여대 357길 상점가,147,65,82
2021,4,R,2130178,이대 앞 스타트업 상점가,32,7,25
2021,4,R,2130177,인왕시장(홍제골목형상점가),44,7,37
2021,4,R,2130176,유진상가,38,23,15
2021,4,R,2130175,신촌 상인회(신촌상점가),13,5,8
2021,4,R,2130173,백련시장,5,3,2
2021,4,R,2130172,모래내시장(서중시장),41,13,28
2021,4,R,2130171,불광먹자골목 골목형상점가,155,54,101
2021,4,R,2130170,제일시장,58,26,32
2021,4,R,2130169,대조시장,67,31,36
2021,4,R,2130168,연서시장,242,157,85
2021,4,R,2130167,연신내상점가(연빛거리),636,239,397
2021,4,R,2130166,응암시장(신응암시장),17,10,7
2021,4,R,2130165,대림골목시장(대림시장 양지시장),214,34,180
2021,4,R,2130164,역촌중앙시장,9,3,6
2021,4,R,2130163,응암오거리상점가,182,49,133
2021,4,R,2130162,증산골목시장,7,3,4
2021,4,R,2130161,증산종합시장,8,5,3
2021,4,R,2130160,수일시장,7,2,5
2021,4,R,2130159,공릉동 도깨비시장,101,47,54
2021,4,R,2130157,상계중앙시장,74,40,34
2021,4,R,2130155,시영B상가(중계 그린아파트 B 상가),12,8,4
2021,4,R,2130153,창동역상점가,229,138,91
2021,4,R,2130152,오!도봉거리 상점가,61,34,27
2021,4,R,2130151,신도봉시장,5,5,0
2021,4,R,2130150,창동골목시장,84,47,37
2021,4,R,2130149,창동신창시장,104,40,64
2021,4,R,2130148,방학동도깨비시장,60,33,27
2021,4,R,2130147,쌍문역동측상점가,69,32,37
2021,4,R,2130146,쌍문시장(쌍문역골목시장),263,124,139
2021,4,R,2130145,쌍문역둘리상점가,244,202,42
2021,4,R,2130144,백운시장,38,17,21
2021,4,R,2130143,방천골목시장,65,36,29
2021,4,R,2130142,강북북부시장,7,5,2
2021,4,R,2130141,강북북부골목시장,43,20,23
2021,4,R,2130140,숭인시장,62,27,35
2021,4,R,2130139,강북종합전통시장(강북종합골목시장),166,114,52
2021,4,R,2130138,수유프라자,142,24,118
2021,4,R,2130137,수유전통시장(수유시장 수유골목시장),89,31,58
2021,4,R,2130136,수유재래시장,29,11,18
2021,4,R,2130135,수유중앙골목시장(수유중앙시장),24,12,12
2021,4,R,2130134,솔샘시장(미아67동골목시장),73,30,43
2021,4,R,2130133,우이골목시장(우이시장),69,61,8
2021,4,R,2130132,삼양골목시장(삼양시장),57,19,38
2021,4,R,2130131,동북프라자,121,49,72
2021,4,R,2130130,수유북부골목시장,20,14,6
2021,4,R,2130129,장미원골목시장,911,571,340
2021,4,R,2130128,돌곶이시장(석관황금시장),191,157,34
2021,4,R,2130126,새석관시장,3,1,2
2021,4,R,2130125,장위전통시장,40,20,20
2021,4,R,2130123,꿈의숲 장곡 골목형상점가,6,5,1
2021,4,R,2130122,밤나무골시장,17,5,12
2021,4,R,2130121,길음시장,91,19,72
2021,4,R,2130120,돈암시장(돈암제일시장),99,23,76
2021,4,R,2130119,정릉아리랑시장,15,4,11
2021,4,R,2130118,정릉골 골목형상점가,67,30,37
2021,4,R,2130117,정릉시장,119,62,57
2021,4,R,2130116,동성타워프라자,31,22,9
2021,4,R,2130115,우림골목시장,307,106,201
2021,4,R,2130114,유영시장,31,20,11
2021,4,R,2130113,신아타운,148,27,121
2021,4,R,2130112,사가정시장,86,28,58
2021,4,R,2130111,동원전통종합시장(동원시장 동원전통시장 상점가),224,109,115
2021,4,R,2130110,면목골목시장(면목시장),103,59,44
2021,4,R,2130109,묵1동도깨비시장,47,33,14
2021,4,R,2130108,태능엔터피아(태릉시장),3,1,2
2021,4,R,2130107,중랑동부시장(중랑교종합상가),13,3,10
2021,4,R,2130106,중랑동부시장,166,56,110
2021,4,R,2130105,장미제일시장(중화동제일시장),63,27,36
2021,4,R,2130104,전곡시장,93,54,39
2021,4,R,2130103,이경시장,16,8,8
2021,4,R,2130101,답십리현대시장,8,5,3
2021,4,R,2130100,답십리시장,93,40,53
2021,4,R,2130099,전농로터리시장,7,3,4
2021,4,R,2130098,회기시장,55,17,38
2021,4,R,2130097,답십리 건축자재시장,315,202,113
2021,4,R,2130096,동부시장,14,9,5
2021,4,R,2130095,청량리전통시장,95,38,57
2021,4,R,2130094,청량리청과물시장,54,24,30
2021,4,R,2130093,동서시장,5,3,2
2021,4,R,2130092,청량리농수산물시장,12,9,3
2021,4,R,2130091,청량종합도매시장,36,27,9
2021,4,R,2130090,청량리종합시장,19,13,6
2021,4,R,2130089,청량리수산시장,42,33,9
2021,4,R,2130088,경동시장,126,57,69
2021,4,R,2130087,경동광성상가(경동시장),28,20,8
2021,4,R,2130086,서울약령시장,1184,651,533
2021,4,R,2130085,용두시장,4,2,2
2021,4,R,2130084,신성시장(신성골목시장),21,6,15
2021,4,R,2130083,중곡제일시장(중곡제일골목시장 광성시장),111,68,43
2021,4,R,2130082,면곡골목시장,20,11,9
2021,4,R,2130081,자양골목전통시장(자양골목시장),54,36,18
2021,4,R,2130080,자양종합시장(기능상실),14,10,4
2021,4,R,2130079,한아름시장,40,29,11
2021,4,R,2130078,화양제일골목시장,65,23,42
2021,4,R,2130077,조양시장,31,19,12
2021,4,R,2130076,능동로골목시장,88,67,21
2021,4,R,2130075,노룬산시장(노룬산골목시장),23,13,10
2021,4,R,2130074,영동교골목시장,21,15,6
2021,4,R,2130073,뚝도시장,45,17,28
2021,4,R,2130072,성동용답상가시장,132,71,61
2021,4,R,2130071,성수역 골목형상점가,335,180,155
2021,4,R,2130070,뚝섬역상점가,1016,697,319
2021,4,R,2130069,한양대앞상점가(한양시장 왕십리맛골목),32,19,13
2021,4,R,2130068,마장축산물시장,975,630,345
2021,4,R,2130067,왕십리도선동상점가,1670,335,1335
2021,4,R,2130066,행당시장상점가,397,182,215
2021,4,R,2130065,무학봉상점가,144,67,77
2021,4,R,2130064,금남시장,36,13,23
2021,4,R,2130063,신금호역 골목형상점가,30,21,9
2021,4,R,2130062,보광시장,31,12,19
2021,4,R,2130061,이태원시장,32,20,12
2021,4,R,2130060,신흥시장,4,1,3
2021,4,R,2130059,후암시장,64,40,24
2021,4,R,2130058,이촌종합시장,109,78,31
2021,4,R,2130057,만리시장,12,9,3
2021,4,R,2130056,용산용문시장,65,34,31
2021,4,R,2130055,황학시장(서울중앙시장 신중앙시장),203,117,86
2021,4,R,2130054,황학동주방가구거리상점가,374,266,108
2021,4,R,2130053,백학시장,160,69,91
2021,4,R,2130052,서울중앙시장(신중앙시장),479,342,137
2021,4,R,2130051,동화동 골목형상점가,391,156,235
2021,4,R,2130050,청평화시장,120,50,70
2021,4,R,2130049,신당 미래유산 먹거리 골목형상점가,42,19,23
2021,4,R,2130048,동평화시장,18,9,9
2021,4,R,2130047,테크노상가(엘리시움),160,112,48
2021,4,R,2130046,team204(팀204),20,13,7
2021,4,R,2130045,광희패션몰,49,29,20
2021,4,R,2130044,에리어식스(벨포스트),10,2,8
2021,4,R,2130043,제일평화시장,43,27,16
2021,4,R,2130042,약수시장,158,67,91
2021,4,R,2130041,신평화패션타운(청계6가 지하도상가),28,21,7
2021,4,R,2130040,남평화시장,5,3,2
2021,4,R,2130039,청계6가 지하도상가,36,26,10
2021,4,R,2130038,평화시장(통일상가 동화상가),930,630,300
2021,4,R,2130036,중부시장(신중부시장),3089,921,2168
2021,4,R,2130035,방산종합시장(방산시장),1190,736,454
2021,4,R,2130034,필동 골목형상점가,14,7,7
2021,4,R,2130033,대림상가(청계상가),169,121,48
2021,4,R,2130032,인현시장,167,123,44
2021,4,R,2130031,청계천공구상가,921,698,223
2021,4,R,2130028,을지입구지하상가(을지로지하보도쇼핑센터),2,2,0
2021,4,R,2130025,삼익패션타운(남대문시장),5494,2675,2819
2021,4,R,2130024,남대문시장(자유상가),732,426,306
2021,4,R,2130022,숭례문수입상가(남대문시장),1907,850,1057
2021,4,R,2130021,신설종합시장,50,37,13
2021,4,R,2130020,동묘시장(동묘벼룩시장),407,177,230
2021,4,R,2130019,동대문상가D동,28,21,7
2021,4,R,2130018,동대문문구완구거리(동대문문구완구시장),215,124,91
2021,4,R,2130017,동대문상가C동,12,9,3
2021,4,R,2130016,동대문상가B동,2,1,1
2021,4,R,2130015,창신골목시장,22,12,10
2021,4,R,2130014,동문시장,3,1,2
2021,4,R,2130012,동대문종합시장(동대문종합시장 신관 동대문종합시장D동상가),1319,965,354
2021,4,R,2130011,충신시장,88,44,44
2021,4,R,2130010,종로신진시장,200,113,87
2021,4,R,2130009,마전교지하쇼핑센터(구 한일상가),24,16,8
2021,4,R,2130007,광장시장(광장전통시장),466,310,156
2021,4,R,2130005,세운상가가동,137,96,41
2021,4,R,2130004,낙원시장(낙원지하시장(대일상가)),364,258,106
2021,4,R,2130002,세종마을음식문화거리(금천교시장),564,392,172
2021,4,R,2130001,통인시장,59,29,30
2021,4,D,2120249,고덕역,1359,916,443
2021,4,D,2120248,명일역,860,332,528
2021,4,D,2120247,굽은다리역,565,307,258
2021,4,D,2120246,길동역,3399,1536,1863
2021,4,D,2120245,둔촌역,1884,1135,749
2021,4,D,2120244,암사역,916,401,515
2021,4,D,2120243,천호역,1353,629,724
2021,4,D,2120242,강동구청역,4528,2937,1591
2021,4,D,2120241,거여역,1197,650,547
2021,4,D,2120240,개롱역,1609,1102,507
2021,4,D,2120239,오금역,4700,3006,1694
2021,4,D,2120238,방이역,412,251,161
2021,4,D,2120237,경찰병원역,8608,5226,3382
2021,4,D,2120236,장지역(가든파이브),4622,3221,1401
2021,4,D,2120235,문정역,907,621,286
2021,4,D,2120234,가락시장역,10268,6224,4044
2021,4,D,2120233,몽촌토성역,10357,5705,4652
2021,4,D,2120232,송파나루역,1269,856,413
2021,4,D,2120231,가락시장,5698,4083,1615
2021,4,D,2120230,송파사거리(송파역),876,470,406
2021,4,D,2120229,방이동먹자골목,7319,4732,2587
2021,4,D,2120228,석촌역(석촌호수),4494,2725,1769
2021,4,D,2120227,잠실역,45438,24212,21226
2021,4,D,2120226,석촌고분역,2408,1777,631
2021,4,D,2120225,잠실새내역(신천),5750,3738,2012
2021,4,D,2120224,수서역,12418,6339,6079
2021,4,D,2120223,휘문고교사거리,9166,5574,3592
2021,4,D,2120222,삼성역,43324,24141,19183
2021,4,D,2120221,봉은사역,19513,12605,6908
2021,4,D,2120220,대치역,5578,3302,2276
2021,4,D,2120219,은마아파트,17161,5791,11370
2021,4,D,2120218,코엑스,290,54,236
2021,4,D,2120217,대치사거리,2779,1478,1301
2021,4,D,2120216,경기고교사거리(경기고교앞사거리),4934,3621,1313
2021,4,D,2120215,포스코사거리,61656,40699,20957
2021,4,D,2120214,영동대교남단교차로,3990,2902,1088
2021,4,D,2120213,삼성중앙역,8472,5131,3341
2021,4,D,2120212,한티역,713,378,335
2021,4,D,2120211,도성초등학교,984,516,468
2021,4,D,2120210,선릉역,48780,26797,21983
2021,4,D,2120209,강남구청(청담역_8번 강남세무서),8984,2608,6376
2021,4,D,2120208,청담사거리(청담동명품거리),10577,4635,5942
2021,4,D,2120207,선정릉역,12151,7422,4729
2021,4,D,2120206,개나리아파트,5280,3376,1904
2021,4,D,2120205,매봉역,13950,9370,4580
2021,4,D,2120204,르네상스호텔사거리,41471,20644,20827
2021,4,D,2120203,강남구청역,7726,4602,3124
2021,4,D,2120202,압구정로데오역(압구정로데오),11735,6075,5660
2021,4,D,2120201,도곡1동,11559,6387,5172
2021,4,D,2120200,학동사거리,9363,3808,5555
2021,4,D,2120199,경복아파트교차로,3830,2283,1547
2021,4,D,2120198,구역삼세무서,11531,7246,4285
2021,4,D,2120197,역삼역,58694,38567,20127
2021,4,D,2120196,서울세관,9687,5900,3787
2021,4,D,2120195,성수대교남단,5611,2685,2926
2021,4,D,2120194,언주역(차병원),12628,8724,3904
2021,4,D,2120193,도산공원교차로,6384,3798,2586
2021,4,D,2120192,뱅뱅사거리,27462,18935,8527
2021,4,D,2120191,학동역,13862,8102,5760
2021,4,D,2120190,강남을지병원,11703,6183,5520
2021,4,D,2120189,강남역,72613,38819,33794
2021,4,D,2120188,압구정역,8579,3750,4829
2021,4,D,2120187,신논현역,13076,7778,5298
2021,4,D,2120186,가로수길,6518,3580,2938
2021,4,D,2120185,논현역,12764,7403,5361
2021,4,D,2120184,포이사거리(삼호물산),10139,7003,3136
2021,4,D,2120183,양재천카페거리,3558,2626,932
2021,4,D,2120182,양재시민의숲역(양재동꽃시장 aT센터),6144,4255,1889
2021,4,D,2120181,교육개발원입구사거리,7278,4440,2838
2021,4,D,2120180,양재화물트럭터미널앞,2562,2146,416
2021,4,D,2120179,양재역,21445,16961,4484
2021,4,D,2120178,신사역,10933,5953,4980
2021,4,D,2120177,신논현역 1번,694,436,258
2021,4,D,2120176,논현역 4번,893,566,327
2021,4,D,2120175,남부터미널역,8239,5313,2926
2021,4,D,2120174,논현역 5번,682,380,302
2021,4,D,2120173,교대역(법원.검찰청),18197,10449,7748
2021,4,D,2120172,교대입구교차로,10241,5712,4529
2021,4,D,2120171,서초3동사거리,11750,6206,5544
2021,4,D,2120170,삼호가든사거리,2026,1161,865
2021,4,D,2120169,서초역,15771,7185,8586
2021,4,D,2120168,서울고교교차로,569,378,191
2021,4,D,2120167,고속터미널(고속터미널역),5078,2994,2084
2021,4,D,2120166,방배역,5467,3282,2185
2021,4,D,2120165,서래마을카페거리(서래마을),3467,2266,1201
2021,4,D,2120164,내방역,8574,5973,2601
2021,4,D,2120163,사당역 11번(사당역먹자골목),491,290,201
2021,4,D,2120162,방배동카페골목,1253,717,536
2021,4,D,2120161,방배동가구거리(사당동가구거리),2517,1833,684
2021,4,D,2120160,사당역(사당),9153,4750,4403
2021,4,D,2120159,서울대입구역,1430,763,667
2021,4,D,2120158,녹두거리(대학동),695,550,145
2021,4,D,2120157,신림역(신림),593,255,338
2021,4,D,2120156,총신대입구역(이수 총신대),3255,1425,1830
2021,4,D,2120155,총신대학교,111,57,54
2021,4,D,2120154,장승배기역,479,199,280
2021,4,D,2120153,노량진역(노량진),3699,1844,1855
2021,4,D,2120152,신대방삼거리역,594,291,303
2021,4,D,2120151,보라매공원,2417,1455,962
2021,4,D,2120150,63빌딩,7632,4749,2883
2021,4,D,2120149,여의도역(여의도),69255,45888,23367
2021,4,D,2120148,국회의사당역(국회의사당),31135,19451,11684
2021,4,D,2120147,보라매역,1981,1262,719
2021,4,D,2120146,한강성심병원,5045,2866,2179
2021,4,D,2120145,영등포역(영등포),3856,1817,2039
2021,4,D,2120144,영중로,2015,1072,943
2021,4,D,2120143,당산역,2723,2018,705
2021,4,D,2120142,대림역,1559,847,712
2021,4,D,2120141,영등포청과시장교차로,601,418,183
2021,4,D,2120140,문래동주민센터,6162,3296,2866
2021,4,D,2120139,대림3동사거리,3619,2404,1215
2021,4,D,2120138,당산2동(영등포우체국),2754,1653,1101
2021,4,D,2120137,문래역(문래로데오거리),50,21,29
2021,4,D,2120136,영등포구청역,6617,3299,3318
2021,4,D,2120135,양평역,5072,3013,2059
2021,4,D,2120134,구로전화국,2014,1668,346
2021,4,D,2120133,서울시흥동우체국(홈플러스시흥점),142,55,87
2021,4,D,2120132,독산동,4203,2884,1319
2021,4,D,2120131,가산디지털단지,81100,53404,27696
2021,4,D,2120130,구로디지털단지역,1136,620,516
2021,4,D,2120129,구로디지털단지,47750,31091,16659
2021,4,D,2120128,신도림역,1253,656,597
2021,4,D,2120127,구로구청,5918,3878,2040
2021,4,D,2120126,디지털단지오거리,135,86,49
2021,4,D,2120125,구로역,9291,6324,2967
2021,4,D,2120124,개봉동 현대아파트,461,205,256
2021,4,D,2120123,오류동역,2120,1645,475
2021,4,D,2120122,강서구청,2137,1208,929
2021,4,D,2120121,까치산역,344,135,209
2021,4,D,2120120,화곡역,927,405,522
2021,4,D,2120119,발산역(마곡),1427,686,741
2021,4,D,2120117,강서농산물도매시장,430,263,167
2021,4,D,2120116,송정역,117,64,53
2021,4,D,2120114,목동신시가지,13614,9392,4222
2021,4,D,2120113,오목교역,628,372,256
2021,4,D,2120112,등촌역,1633,1138,495
2021,4,D,2120111,목동사거리,1828,710,1118
2021,4,D,2120110,목동역 8번출구,1858,1400,458
2021,4,D,2120109,서울남부지방법원,608,342,266
2021,4,D,2120108,신정네거리역,992,580,412
2021,4,D,2120107,공덕역(공덕오거리),13077,7619,5458
2021,4,D,2120106,마포역,11462,7104,4358
2021,4,D,2120105,상수역(홍대),524,273,251
2021,4,D,2120104,연남동(홍대),5955,3176,2779
2021,4,D,2120103,홍대입구역(홍대),9580,5991,3589
2021,4,D,2120102,서교동(홍대),7276,3402,3874
2021,4,D,2120101,합정역,1932,1048,884
2021,4,D,2120100,망원역,900,436,464
2021,4,D,2120099,월드컵경기장역(월드컵경기장),84,57,27
2021,4,D,2120098,DMC(디지털미디어시티),8846,5391,3455
2021,4,D,2120097,충정로역,2246,1354,892
2021,4,D,2120096,이화여대(이대역 이대),470,195,275
2021,4,D,2120095,홍제역,922,520,402
2021,4,D,2120094,신촌역(신촌역 신촌로터리),5355,2430,2925
2021,4,D,2120093,연희동,661,351,310
2021,4,D,2120092,불광역,274,147,127
2021,4,D,2120091,본서부병원,516,192,324
2021,4,D,2120090,연신내역,687,262,425
2021,4,D,2120089,구파발역,1,0,1
2021,4,D,2120088,구산역,799,279,520
2021,4,D,2120087,응암역,441,272,169
2021,4,D,2120086,태릉입구역,382,205,177
2021,4,D,2120085,은행사거리,317,121,196
2021,4,D,2120084,공릉역,712,546,166
2021,4,D,2120083,등나무근린공원,1184,787,397
2021,4,D,2120082,상계백병원,426,148,278
2021,4,D,2120081,노원역,1552,508,1044
2021,4,D,2120080,마들역,180,46,134
2021,4,D,2120079,창동역,1326,796,530
2021,4,D,2120078,미아사거리역,145,90,55
2021,4,D,2120077,미아역,218,97,121
2021,4,D,2120076,수유역,1930,865,1065
2021,4,D,2120075,월곡역,369,213,156
2021,4,D,2120074,안암역,59,28,31
2021,4,D,2120073,미아사거리,353,135,218
2021,4,D,2120072,성신여대,1048,537,511
2021,4,D,2120071,성북구청,255,127,128
2021,4,D,2120070,한성대입구역,466,180,286
2021,4,D,2120069,상봉역,932,597,335
2021,4,D,2120068,사가정역,145,45,100
2021,4,D,2120067,장안동사거리,2587,1169,1418
2021,4,D,2120066,장한평역(장한평),7424,4770,2654
2021,4,D,2120065,회기역,326,207,119
2021,4,D,2120064,경희대학교(경희대),97,44,53
2021,4,D,2120063,청량리역(청량리),1182,514,668
2021,4,D,2120062,신설동역,12641,5433,7208
2021,4,D,2120061,올림픽대교북단,1094,864,230
2021,4,D,2120060,강변역(테크노마트),3189,2348,841
2021,4,D,2120059,구삼강변맛길,3279,1781,1498
2021,4,D,2120058,구의사거리,688,333,355
2021,4,D,2120057,아차산역,2218,1220,998
2021,4,D,2120056,구의역,2200,1115,1085
2021,4,D,2120055,군자역,4255,2030,2225
2021,4,D,2120054,어린이대공원역,1243,826,417
2021,4,D,2120053,건대입구역(건대),859,491,368
2021,4,D,2120052,성수역,11387,7284,4103
2021,4,D,2120051,뚝섬역,3944,2582,1362
2021,4,D,2120050,서울숲역,212,159,53
2021,4,D,2120049,왕십리역(왕십리),1459,1004,455
2021,4,D,2120048,금호역,80,31,49
2021,4,D,2120047,한남오거리,2290,1458,832
2021,4,D,2120046,이태원(이태원역),2276,1295,981
2021,4,D,2120045,남영동 먹자골목,4044,1580,2464
2021,4,D,2120044,삼각지역,1611,1164,447
2021,4,D,2120043,서울역,22578,15322,7256
2021,4,D,2120042,숙대입구역(남영역 남영동),4057,2797,1260
2021,4,D,2120041,신용산역(용산역),16270,5741,10529
2021,4,D,2120040,용산전자상가(용산역),8014,5960,2054
2021,4,D,2120039,신당역,2321,1230,1091
2021,4,D,2120038,약수역,2289,1360,929
2021,4,D,2120037,동대문역사문화공원역,35320,17057,18263
2021,4,D,2120036,장충동족발거리(남소영길),2289,1090,1199
2021,4,D,2120035,퇴계로5가,2257,1368,889
2021,4,D,2120034,중구청(퇴계로4가),1538,1044,494
2021,4,D,2120033,을지로4가역,874,443,431
2021,4,D,2120032,충무로역,11403,5304,6099
2021,4,D,2120031,을지로3가역,6147,3450,2697
2021,4,D,2120030,중부경찰서(영화인의거리),11889,6798,5091
2021,4,D,2120029,을지로2가,7461,4461,3000
2021,4,D,2120028,명동(명동거리),12797,7708,5089
2021,4,D,2120027,명동역(명동재미로),18097,8477,9620
2021,4,D,2120026,을지로입구역,30610,18501,12109
2021,4,D,2120025,롯데백화점(시청광장 지하쇼핑센터),22641,6272,16369
2021,4,D,2120024,회현역,2167,1364,803
2021,4,D,2120023,서울시청,10242,5534,4708
2021,4,D,2120022,북창동(시청역_6번),5197,3160,2037
2021,4,D,2120021,시청역_8번,24117,15220,8897
2021,4,D,2120020,시청역_1번,10375,7489,2886
2021,4,D,2120019,경찰청앞교차로,5958,3146,2812
2021,4,D,2120018,중림동,2187,1366,821
2021,4,D,2120017,동묘앞역(동묘),626,149,477
2021,4,D,2120016,동대문역,193,120,73
2021,4,D,2120015,종로6가,302,153,149
2021,4,D,2120014,종로5가역,4887,2839,2048
2021,4,D,2120013,이화사거리,7552,5465,2087
2021,4,D,2120012,대학로(혜화역),2061,929,1132
2021,4,D,2120011,종로4가,2980,1663,1317
2021,4,D,2120010,원남동사거리,4107,2297,1810
2021,4,D,2120009,종로3가역,8495,4786,3709
2021,4,D,2120008,인사동,22070,13019,9051
2021,4,D,2120007,북촌(안국역),10172,8081,2091
2021,4,D,2120006,종각역,33181,16028,17153
2021,4,D,2120005,삼청동,3053,2795,258
2021,4,D,2120004,종로구청,12937,7078,5859
2021,4,D,2120003,광화문역,44202,27021,17181
2021,4,D,2120002,서촌(경복궁역),2008,1079,929
2021,4,D,2120001,서대문역,1510,1022,488
2021,4,A,2111090,강일동주민센터,91,35,56
2021,4,A,2111089,상일여고(상일초등학교),758,508,250
2021,4,A,2111088,고덕동성당,123,54,69
2021,4,A,2111087,고덕중학교(고덕2동주민센터),197,89,108
2021,4,A,2111086,한영중고,297,202,95
2021,4,A,2111085,묘곡초등학교(고덕아이파크아파트),800,452,348
2021,4,A,2111084,길동신동아아파트,169,104,65
2021,4,A,2111083,GS강동자이아파트,411,245,166
2021,4,A,2111082,중앙보훈병원,64,44,20
2021,4,A,2111081,둔촌푸르지오아파트,78,50,28
2021,4,A,2111080,굽은다리역 3번,434,235,199
2021,4,A,2111079,둔촌고등학교(둔촌중학교),395,202,193
2021,4,A,2111078,굽은다리역 4번,1728,1017,711
2021,4,A,2111077,길동주민센터(강동도서관),1272,737,535
2021,4,A,2111076,둔촌2동주민센터,297,174,123
2021,4,A,2111075,굽은다리역 2번,192,115,77
2021,4,A,2111074,명일역 1번,148,77,71
2021,4,A,2111073,둔촌동역 1번(한산중학교),973,578,395
2021,4,A,2111072,굽은다리역 1번(십자성마을),739,467,272
2021,4,A,2111071,천동초등학교,76,52,24
2021,4,A,2111070,천호초등학교,127,73,54
2021,4,A,2111069,천호1동주민센터,79,54,25
2021,4,A,2111068,강동성심병원,1570,605,965
2021,4,A,2111067,강동구립성내도서관,746,414,332
2021,4,A,2111066,암사동성당(효정하나플러스아파트),395,235,160
2021,4,A,2111065,천일초등학교,75,34,41
2021,4,A,2111064,둔촌동역 4번,157,98,59
2021,4,A,2111063,강동구립 천호도서관,368,182,186
2021,4,A,2111062,둔촌동역 3번(성내3동주민센터),751,501,250
2021,4,A,2111061,암사역 1번,831,551,280
2021,4,A,2111060,암사역 2번(서울강동초등학교),871,457,414
2021,4,A,2111059,강동역 4번(강풀만화거리),819,430,389
2021,4,A,2111058,성내중학교,451,317,134
2021,4,A,2111057,천호공원(해공체육문화센터),255,113,142
2021,4,A,2111056,천호태영아파트,191,53,138
2021,4,A,2111055,선사초등학교,673,29,644
2021,4,A,2111054,암사역 4번(삼성광나루아파트),104,42,62
2021,4,A,2111053,성내천어린이공원(하니사랑길),6288,4564,1724
2021,4,A,2111052,암사역 3번(천호동자전거거리),357,228,129
2021,4,A,2111051,천호역 6번,407,252,155
2021,4,A,2111050,강동구청(강동구청역 2번),131,96,35
2021,4,A,2111049,천호지구대(천호동자전거거리),507,277,230
2021,4,A,2111048,천호역 1번(천호문구완구거리),189,104,85
2021,4,A,2111047,마천1치안센터,111,73,38
2021,4,A,2111046,마천역(마천초등학교),705,400,305
2021,4,A,2111045,개미어린이공원,36,18,18
2021,4,A,2111044,남천초등학교,557,264,293
2021,4,A,2111043,마천공원,32,13,19
2021,4,A,2111042,거여역 1번(거여공원),867,597,270
2021,4,A,2111041,거여역 8번,428,350,78
2021,4,A,2111040,거여초등학교,346,137,209
2021,4,A,2111039,벌말어린이공원,485,353,132
2021,4,A,2111038,보인중학교,416,270,146
2021,4,A,2111037,Sh수협은행 오금동금융센터(아랫말어린이공원),373,243,130
2021,4,A,2111036,투구봉어린이공원,209,119,90
2021,4,A,2111035,오금공원(오주중학교),531,398,133
2021,4,A,2111034,오동나무공원(송파레미니스1단지),1443,1020,423
2021,4,A,2111033,문정동성당,70,30,40
2021,4,A,2111032,방이역 1번,3885,2552,1333
2021,4,A,2111031,장지동주민센터(한림연예예술고교),3127,2317,810
2021,4,A,2111030,방이역 2번,665,419,246
2021,4,A,2111029,오금역 4번,427,314,113
2021,4,A,2111028,문현중학교(장지역 1번),424,194,230
2021,4,A,2111027,문정초등학교,1403,775,628
2021,4,A,2111026,문정역 2번,2304,1506,798
2021,4,A,2111025,경찰병원역 3번,686,412,274
2021,4,A,2111024,경찰병원역 4번(건너말공원),240,150,90
2021,4,A,2111023,문정역 1번,939,576,363
2021,4,A,2111022,석촌중학교(방이육교),567,255,312
2021,4,A,2111021,방이역 4번,7674,5867,1807
2021,4,A,2111020,방이동고분군(방산고등학교),304,225,79
2021,4,A,2111019,한성백제역 3번,1524,1000,524
2021,4,A,2111018,풍납초등학교(풍납백제문화공원),26,23,3
2021,4,A,2111017,송파나루역 3번,688,480,208
2021,4,A,2111016,송파역 2번,3803,1601,2202
2021,4,A,2111015,석촌역 3번,1352,778,574
2021,4,A,2111014,송파나루역 2번,525,275,250
2021,4,A,2111013,송파나루역 1번(송리단길),2234,1456,778
2021,4,A,2111012,석촌역 6번,732,332,400
2021,4,A,2111011,잠실나루역,9608,7747,1861
2021,4,A,2111010,석촌역 7번,1428,975,453
2021,4,A,2111009,송파책박물관,127,92,35
2021,4,A,2111008,석촌고분역 3번,1600,1210,390
2021,4,A,2111007,석촌고분역 4번,936,480,456
2021,4,A,2111006,석촌고분역 1번,1112,721,391
2021,4,A,2111005,삼전역 3번,1865,1358,507
2021,4,A,2111004,삼전역 1번,2036,1331,705
2021,4,A,2111003,삼전역 4번,1991,1333,658
2021,4,A,2111002,한국교통안전공단 강남자동차검사소,317,115,202
2021,4,A,2111001,아래방죽마을공원(율현초등학교),70,44,26
2021,4,A,2111000,대왕초등학교(세곡동사거리서남측),39,20,19
2021,4,A,2110999,윗방죽마을공원,268,130,138
2021,4,A,2110998,은곡마을(은곡마을공원),23,15,8
2021,4,A,2110997,대청초등학교,1724,959,765
2021,4,A,2110996,대치2동주민센터,1959,1227,732
2021,4,A,2110995,봉은사역 4번,5085,3711,1374
2021,4,A,2110994,개포고등학교,494,382,112
2021,4,A,2110993,개포지하차도 북측,70,53,17
2021,4,A,2110992,도곡초등학교,2179,1144,1035
2021,4,A,2110991,삼성중앙역 5번,1246,794,452
2021,4,A,2110990,청담역 12번,262,109,153
2021,4,A,2110989,대치동아우편취급국,444,270,174
2021,4,A,2110988,청담역 3번,1594,1016,578
2021,4,A,2110987,영동대교남단,473,237,236
2021,4,A,2110986,삼성중앙역 7번,90,59,31
2021,4,A,2110985,청담근린공원,1338,948,390
2021,4,A,2110984,포이초등학교(개포목련어린이공원),1556,1046,510
2021,4,A,2110983,국립국악고등학교,783,534,249
2021,4,A,2110982,강남구보훈회관,166,74,92
2021,4,A,2110981,국악고교사거리,361,216,145
2021,4,A,2110980,개포지구대옆,663,482,181
2021,4,A,2110979,청담초등학교,2996,1912,1084
2021,4,A,2110978,도곡2동주민센터(대치중학교),331,186,145
2021,4,A,2110977,논현로18길,148,102,46
2021,4,A,2110976,언북초등학교,578,332,246
2021,4,A,2110975,매봉역 1번,10837,6932,3905
2021,4,A,2110974,언주중학교,292,179,113
2021,4,A,2110973,강남구청역 4번,1451,786,665
2021,4,A,2110972,강남세브란스병원미래의학연구센터,2628,1440,1188
2021,4,A,2110971,선정릉역 4번,1542,900,642
2021,4,A,2110970,학동초등학교,378,236,142
2021,4,A,2110969,베르사이유1아파트,1546,1230,316
2021,4,A,2110968,강남구청역 2번,1023,596,427
2021,4,A,2110967,역삼역 8번,377,228,149
2021,4,A,2110966,논현2동주민센터,1637,1017,620
2021,4,A,2110965,언주역 6번,1139,788,351
2021,4,A,2110964,싸리고개근린공원,217,124,93
2021,4,A,2110963,역삼월드메르디앙아파트,780,547,233
2021,4,A,2110962,도산공원북측,557,487,70
2021,4,A,2110961,언주역 3번,962,673,289
2021,4,A,2110960,은광여고,1522,692,830
2021,4,A,2110959,신구중학교,271,140,131
2021,4,A,2110958,역삼역 4번,994,759,235
2021,4,A,2110957,언북중학교,1251,831,420
2021,4,A,2110956,언주역 8번,1199,758,441
2021,4,A,2110955,논현초등학교,3430,2238,1192
2021,4,A,2110954,국기원,636,445,191
2021,4,A,2110953,학동근린공원,2487,1583,904
2021,4,A,2110952,논현목련공원,117,65,52
2021,4,A,2110951,신사은행나무공원,273,75,198
2021,4,A,2110950,논현역 7번,2981,1929,1052
2021,4,A,2110949,한남IC,1683,1193,490
2021,4,A,2110947,청계산입구역 2번(내곡동주민센터),121,48,73
2021,4,A,2110946,청계산원터골,48,24,24
2021,4,A,2110945,본마을노인복지센터(서초구립내곡도서관),191,114,77
2021,4,A,2110944,서울나래학교(염곡어린이공원),1053,735,318
2021,4,A,2110943,법제교육센터(버들어린이공원),1122,578,544
2021,4,A,2110942,염곡동 구룡사(포이동성당),3242,1952,1290
2021,4,A,2110941,언남고등학교,261,158,103
2021,4,A,2110940,양재근린공원(양재2동주민센터),1043,755,288
2021,4,A,2110939,양재역 8번(양재동우체국),5945,4103,1842
2021,4,A,2110938,바우뫼공원,1784,1137,647
2021,4,A,2110937,방아다리근린공원(횃불트리니티신학대학원대학교),2465,1270,1195
2021,4,A,2110936,더케이호텔(양재리본타워2단지아파트),832,552,280
2021,4,A,2110935,한전아트센터,379,264,115
2021,4,A,2110934,우면주공아파트,998,677,321
2021,4,A,2110933,한국상담대학원대학교,679,60,619
2021,4,A,2110932,서울시인재개발원,532,384,148
2021,4,A,2110931,삼성전자서울R&D(서울우면초등학교),100,51,49
2021,4,A,2110930,서초동성당,2178,1774,404
2021,4,A,2110929,남부터미널역 1번,21130,10703,10427
2021,4,A,2110928,서초우방유쉘아파트,596,491,105
2021,4,A,2110927,잠원역,745,553,192
2021,4,A,2110926,신중초등학교,1610,1175,435
2021,4,A,2110925,서초중학교,873,496,377
2021,4,A,2110924,반포4동주민센터(몽마르뜨공원),1330,886,444
2021,4,A,2110923,방배역 1번,210,153,57
2021,4,A,2110922,내방역 1번,224,114,110
2021,4,A,2110921,서울프랑스학교,522,321,201
2021,4,A,2110920,방배역 2번(백석예술대학교),359,205,154
2021,4,A,2110919,내방역 8번,1539,1126,413
2021,4,A,2110918,방배역 3번,682,438,244
2021,4,A,2110917,서초소방서,1505,939,566
2021,4,A,2110916,내방역 4번,1152,592,560
2021,4,A,2110915,서래초등학교,2807,2202,605
2021,4,A,2110914,내방역 6번,146,116,30
2021,4,A,2110913,방현초등학교(방배119안전센터),3305,2117,1188
2021,4,A,2110912,방배동사이길,210,128,82
2021,4,A,2110911,방배배수지체육공원,29,22,7
2021,4,A,2110910,내방역 5번,614,240,374
2021,4,A,2110909,남태령역(서울전자고등학교),132,97,35
2021,4,A,2110908,구반포역,1525,377,1148
2021,4,A,2110907,방배초등학교,878,506,372
2021,4,A,2110906,서문여고,683,362,321
2021,4,A,2110905,방배노인종합복지관(이수중학교),287,176,111
2021,4,A,2110904,이수역 5번,835,468,367
2021,4,A,2110903,방배아이파크아파트,7222,2653,4569
2021,4,A,2110902,사당역 4번,1201,739,462
2021,4,A,2110901,인헌고등학교(인헌중학교),262,154,108
2021,4,A,2110900,낙성대역 1번(관악구민 종합체육센터),457,257,200
2021,4,A,2110899,낙성대역 5번(관악중학교),690,448,242
2021,4,A,2110898,청림동주민센터(상도중학교),66,27,39
2021,4,A,2110897,서울대입구역 8번,219,139,80
2021,4,A,2110896,관악우성아파트,202,49,153
2021,4,A,2110895,샤로수길,1796,1222,574
2021,4,A,2110894,관악동부센트레빌아파트(은천로35라길),20,8,12
2021,4,A,2110893,관악소방서(문영여고),353,303,50
2021,4,A,2110892,관악구 중앙길,709,341,368
2021,4,A,2110891,구암초등학교,47,22,25
2021,4,A,2110890,봉천역 1번(관악초등학교),261,152,109
2021,4,A,2110889,봉천역 6번,376,317,59
2021,4,A,2110888,청룡동주민센터,94,53,41
2021,4,A,2110887,서울산업정보학교(서울삼성초등학교),19,11,8
2021,4,A,2110886,관악해태어린이공원,188,103,85
2021,4,A,2110885,영락고등학교,340,214,126
2021,4,A,2110884,봉천역 4번(봉천110안전센터),372,284,88
2021,4,A,2110883,은천초등학교(은천교앞),212,126,86
2021,4,A,2110882,신성초등학교,733,444,289
2021,4,A,2110881,구립대학경로당(관악산샘말공원),1601,1304,297
2021,4,A,2110880,신림역 1번,995,275,720
2021,4,A,2110879,신림현대아파트,17,7,10
2021,4,A,2110878,미림여고,368,218,150
2021,4,A,2110877,신림역 8번,319,154,165
2021,4,A,2110876,서원동주민센터(신관중학교),49,29,20
2021,4,A,2110875,보라매동주민센터(당곡고등학교),16,13,3
2021,4,A,2110874,원신초등학교(구세군관악영문교회),46,15,31
2021,4,A,2110873,당곡중학교,343,166,177
2021,4,A,2110872,신림초등학교,277,195,82
2021,4,A,2110871,신원동주민센터,159,101,58
2021,4,A,2110869,신림역 5번(신림동주민센터 신림동별빛거리),1026,681,345
2021,4,A,2110868,남부초등학교,232,126,106
2021,4,A,2110867,국제신학대학원대학교(남서울중학교),202,117,85
2021,4,A,2110866,난우중학교,171,91,80
2021,4,A,2110865,남강고등학교(남강중학교),336,143,193
2021,4,A,2110864,신림우방아파트,236,161,75
2021,4,A,2110863,난우초등학교,319,179,140
2021,4,A,2110862,난곡초등학교(난곡동벽화마을),84,41,43
2021,4,A,2110861,관악구신사동주민센터,1182,608,574
2021,4,A,2110860,호림박물관(성보고등학교),410,314,96
2021,4,A,2110859,난향초등학교,182,113,69
2021,4,A,2110858,신대방역 1번,66,33,33
2021,4,A,2110857,미성동주민센터,431,229,202
2021,4,A,2110856,미성초등학교,538,295,243
2021,4,A,2110855,신대방역 2번,429,275,154
2021,4,A,2110854,조원동주민센터,55,39,16
2021,4,A,2110853,KT구로지사,213,127,86
2021,4,A,2110852,이수역 9번,198,121,77
2021,4,A,2110851,경문고등학교(동작동성당),485,233,252
2021,4,A,2110850,사당역 10번,969,487,482
2021,4,A,2110849,이수역 10번,220,130,90
2021,4,A,2110848,양지어린이공원,486,307,179
2021,4,A,2110847,예술인마을,460,225,235
2021,4,A,2110846,남성역 1번,535,290,245
2021,4,A,2110845,사당종합체육관,119,51,68
2021,4,A,2110844,흑석2치안센터,7,5,2
2021,4,A,2110843,사당5동주민센터,181,135,46
2021,4,A,2110842,흑리단길,43,14,29
2021,4,A,2110841,중대부중,88,36,52
2021,4,A,2110840,중앙대학교,165,92,73
2021,4,A,2110839,숭실대입구역 4번,187,67,120
2021,4,A,2110838,상도1동주민센터앞,131,122,9
2021,4,A,2110837,숭실대입구역 1번,373,195,178
2021,4,A,2110836,상도역 5번,3057,1846,1211
2021,4,A,2110835,상도역 1번,285,161,124
2021,4,A,2110834,동작구자원봉사센터,38,22,16
2021,4,A,2110833,상도역 2번,266,172,94
2021,4,A,2110832,노량진초등학교,377,171,206
2021,4,A,2110831,상도4동주민센터,72,40,32
2021,4,A,2110830,상도초등학교,281,152,129
2021,4,A,2110829,장승배기역 5번,536,417,119
2021,4,A,2110828,노량진역 6번,3010,2066,944
2021,4,A,2110827,NH농협은행 상도동지점,262,93,169
2021,4,A,2110826,장승배기역 4번,366,149,217
2021,4,A,2110825,신대방삼거리역 1번,316,205,111
2021,4,A,2110824,대방역 3번,296,102,194
2021,4,A,2110823,신대방삼거리역 3번,472,242,230
2021,4,A,2110822,신대방삼거리역 4번(대림초등학교),311,130,181
2021,4,A,2110821,보라매역 2번,595,353,242
2021,4,A,2110820,성남고등학교,3101,2470,631
2021,4,A,2110819,신대방역 4번,510,262,248
2021,4,A,2110818,신대방역 3번,20,9,11
2021,4,A,2110817,대방역 4번,286,227,59
2021,4,A,2110816,대방역 6번,521,404,117
2021,4,A,2110815,공군호텔,2240,785,1455
2021,4,A,2110814,서울지방병무청,673,364,309
2021,4,A,2110813,보라매역 6번,286,167,119
2021,4,A,2110812,신길6동주민센터,363,245,118
2021,4,A,2110811,보라매역 4번,187,94,93
2021,4,A,2110810,영신초등학교,395,178,217
2021,4,A,2110809,장훈고등학교,112,61,51
2021,4,A,2110808,신길역 1번,67,48,19
2021,4,A,2110807,신길역 3번,102,70,32
2021,4,A,2110806,서울시립영등포장애인복지관,76,42,34
2021,4,A,2110805,신길새마을금고신길4동지점,45,27,18
2021,4,A,2110804,신풍역 1번,312,187,125
2021,4,A,2110803,신길2동우편취급국,304,220,84
2021,4,A,2110802,신길동홍어거리,336,159,177
2021,4,A,2110800,영등포동성당,227,153,74
2021,4,A,2110799,영등포본동주민센터,119,86,33
2021,4,A,2110798,신풍역 2번,53,20,33
2021,4,A,2110797,KT대방빌딩,52,10,42
2021,4,A,2110796,한림대학교한강성심병원,87,52,35
2021,4,A,2110795,도림초등학교,533,356,177
2021,4,A,2110794,영동초등학교,632,494,138
2021,4,A,2110792,영등포역 2번,3400,1767,1633
2021,4,A,2110791,신풍역 3번,25,17,8
2021,4,A,2110790,대림1동주민센터,739,336,403
2021,4,A,2110789,대림성모병원,491,182,309
2021,4,A,2110788,영등포시장역 3번,28,22,6
2021,4,A,2110787,신길3동주민센터,171,122,49
2021,4,A,2110786,당산역 8번,271,179,92
2021,4,A,2110785,영등포푸르지오아파트,161,84,77
2021,4,A,2110784,신대림초등학교,76,42,34
2021,4,A,2110783,영등포시장역 1번,292,154,138
2021,4,A,2110782,영등포시장역 4번,127,87,40
2021,4,A,2110781,대림한신아파트,182,112,70
2021,4,A,2110780,신길대성유니드아파트,223,171,52
2021,4,A,2110779,대림갑을명가아파트,33,24,9
2021,4,A,2110778,구로디지털단지역 4번,1615,878,737
2021,4,A,2110777,구로세무서,282,210,72
2021,4,A,2110776,도신초등학교,168,106,62
2021,4,A,2110775,대동초등학교,61,30,31
2021,4,A,2110774,당산반도유보라팰리스아파트,472,355,117
2021,4,A,2110773,당산역 13번,272,218,54
2021,4,A,2110772,신우어린이공원,94,55,39
2021,4,A,2110771,대림역 11번,955,604,351
2021,4,A,2110770,영등포구청역 6번,263,191,72
2021,4,A,2110769,대림차이나타운(대림역 12번),18,8,10
2021,4,A,2110768,도림2동유수지내체육시설,294,155,139
2021,4,A,2110767,도림동주민센터,34,3,31
2021,4,A,2110766,대림역 5번,360,205,155
2021,4,A,2110765,문래동사거리,889,619,270
2021,4,A,2110764,문래역 3번,541,223,318
2021,4,A,2110763,영등포구청역 2번,480,353,127
2021,4,A,2110762,선유도역 1번,3139,2286,853
2021,4,A,2110761,문래동남성맨션,180,106,74
2021,4,A,2110760,선유도역 6번,1792,1091,701
2021,4,A,2110759,문래예술촌(문래창작촌),4221,2165,2056
2021,4,A,2110758,문래소공원,296,221,75
2021,4,A,2110757,양평역 2번,1501,1114,387
2021,4,A,2110756,문래중학교,275,179,96
2021,4,A,2110755,동일여자고등학교,199,53,146
2021,4,A,2110754,삼성산자연공원(서울금천초등학교),199,75,124
2021,4,A,2110753,시흥동 은행나무사거리,617,387,230
2021,4,A,2110752,한울중학교,269,117,152
2021,4,A,2110751,난곡중학교,730,397,333
2021,4,A,2110750,시흥4동주민센터(서울신흥초등학교),397,221,176
2021,4,A,2110749,금산초등학교(금천고등학교),448,273,175
2021,4,A,2110748,백산초등학교,102,64,38
2021,4,A,2110747,석수역 1번 출입구,823,612,211
2021,4,A,2110746,금천금빛공원(은행나무사거리서측),70,48,22
2021,4,A,2110745,독산동정훈단지,251,191,60
2021,4,A,2110744,독산동성당,531,327,204
2021,4,A,2110743,시흥초등학교(시흥1동우체국),191,130,61
2021,4,A,2110742,KT금천빌딩(금천구시설관리공단),426,237,189
2021,4,A,2110741,독산2동주민센터,444,159,285
2021,4,A,2110740,금천해태공원,650,283,367
2021,4,A,2110739,시흥3동 우편취급국,1558,585,973
2021,4,A,2110738,문성초등학교,249,125,124
2021,4,A,2110737,금천세무서,506,324,182
2021,4,A,2110736,독산119안전센터,450,196,254
2021,4,A,2110735,말미고개,520,330,190
2021,4,A,2110734,금천파출소,92,47,45
2021,4,A,2110733,금천어울림복지센터,374,293,81
2021,4,A,2110732,가산초등학교(세일중학교),338,239,99
2021,4,A,2110731,금천구청역 1번 출입구,1041,563,478
2021,4,A,2110730,서울축산농협 독산역지점(독산파출소),660,376,284
2021,4,A,2110729,가산동우체국,151,112,39
2021,4,A,2110728,두산초등학교,4560,2778,1782
2021,4,A,2110727,독산역 1번 출입구,659,514,145
2021,4,A,2110726,금천철쭉어린이공원(금하마을),222,172,50
2021,4,A,2110725,가산동주민센터,85,59,26
2021,4,A,2110724,금천구립가산도서관,366,254,112
2021,4,A,2110723,가산디지털단지역 1번 출입구,286,247,39
2021,4,A,2110722,G타워,1221,876,345
2021,4,A,2110721,가리봉파출소,215,104,111
2021,4,A,2110720,대림역 2번,158,73,85
2021,4,A,2110719,영서중학교,52,44,8
2021,4,A,2110718,한국SGI본부,1614,1061,553
2021,4,A,2110717,남구로역 2번,570,271,299
2021,4,A,2110716,구로나눔길,666,398,268
2021,4,A,2110715,구로구민회관,93,64,29
2021,4,A,2110714,구로4동주민센터,271,156,115
2021,4,A,2110713,구로보건소,2668,1817,851
2021,4,A,2110712,남구로역 5번,233,108,125
2021,4,A,2110711,구로초등학교,818,332,486
2021,4,A,2110710,남구로역 3번,606,370,236
2021,4,A,2110709,구로119안전센터,162,94,68
2021,4,A,2110708,화원어린이공원,64,27,37
2021,4,A,2110707,구로창업지원센터,1045,760,285
2021,4,A,2110706,그라운드 고척,410,100,310
2021,4,A,2110705,고산초등학교,33,19,14
2021,4,A,2110704,고척중학교,62,36,26
2021,4,A,2110703,개봉역,569,449,120
2021,4,A,2110702,개봉초등학교,131,93,38
2021,4,A,2110701,고척동성당,567,379,188
2021,4,A,2110700,고척초등학교,3249,2648,601
2021,4,A,2110699,덕의초등학교,150,89,61
2021,4,A,2110698,개웅초등학교(개웅중학교),279,178,101
2021,4,A,2110697,개봉3동주민센터,244,152,92
2021,4,A,2110696,오류동역 1번,2453,1671,782
2021,4,A,2110695,개봉1동주민센터,546,314,232
2021,4,A,2110694,세곡초등학교,445,249,196
2021,4,A,2110693,오류동역 4번,17,9,8
2021,4,A,2110692,큰굴다리,233,148,85
2021,4,A,2110691,개봉중학교,395,205,190
2021,4,A,2110690,오류2동버들시장,625,318,307
2021,4,A,2110689,오류동역 3번,259,188,71
2021,4,A,2110688,오류지구대,171,60,111
2021,4,A,2110687,천왕역 3번(오류2동주민센터 서울오류남초등학교),21,16,5
2021,4,A,2110686,수궁동주민센터,490,245,245
2021,4,A,2110685,금강수목원아파트,181,143,38
2021,4,A,2110684,서울공연예술고등학교,157,72,85
2021,4,A,2110683,오류고등학교,185,125,60
2021,4,A,2110682,온수역 8번,137,128,9
2021,4,A,2110681,온수역 1번,152,106,46
2021,4,A,2110680,온수역 5번(온수산업단지),1184,1003,181
2021,4,A,2110679,염창역 2번,578,407,171
2021,4,A,2110678,염창무학아파트,242,188,54
2021,4,A,2110677,등촌역 1번,410,321,89
2021,4,A,2110676,등촌역 7번,237,141,96
2021,4,A,2110675,화곡4동주민센터,289,186,103
2021,4,A,2110674,강서구청가양동별관,491,327,164
2021,4,A,2110673,뜸부기어린이공원,253,143,110
2021,4,A,2110672,백석중학교,155,99,56
2021,4,A,2110671,등촌1동주민센터,5012,3056,1956
2021,4,A,2110670,신곡초등학교,527,322,205
2021,4,A,2110669,화곡보람2차아파트,80,49,31
2021,4,A,2110668,화곡2동주민센터,471,278,193
2021,4,A,2110667,가양역 10번,177,126,51
2021,4,A,2110666,KC대학교,257,131,126
2021,4,A,2110665,곰달래도서관,469,285,184
2021,4,A,2110664,강서구청옆,111,48,63
2021,4,A,2110663,우장산롯데캐슬아파트앞,316,232,84
2021,4,A,2110662,까치산역 1번,1480,885,595
2021,4,A,2110661,강서새말어린이공원,126,48,78
2021,4,A,2110660,등촌3동주민센터,4614,2039,2575
2021,4,A,2110659,화곡역 4번,867,512,355
2021,4,A,2110658,화곡초등학교,253,153,100
2021,4,A,2110657,양천향교역 5번,3180,2118,1062
2021,4,A,2110656,까치산역 3번,838,498,340
2021,4,A,2110655,발산역 5번,587,355,232
2021,4,A,2110654,까치산역 4번,1021,686,335
2021,4,A,2110653,화곡역 2번,910,490,420
2021,4,A,2110652,양천향교역 2번,643,483,160
2021,4,A,2110651,화원중학교,377,214,163
2021,4,A,2110650,우장산힐스테이트,146,118,28
2021,4,A,2110649,우장산역 1번,366,197,169
2021,4,A,2110648,양천향교역 7번,13,5,8
2021,4,A,2110647,화곡역 5번,890,459,431
2021,4,A,2110646,푸른들청소년도서관,782,401,381
2021,4,A,2110645,우장산역 4번,794,391,403
2021,4,A,2110644,신광명마을,333,288,45
2021,4,A,2110643,강서구다솔마을,653,413,240
2021,4,A,2110642,정곡초등학교,193,163,30
2021,4,A,2110641,공항고등학교,345,236,109
2021,4,A,2110640,방화역 1번,1019,638,381
2021,4,A,2110639,신방화역 8번,523,369,154
2021,4,A,2110638,신방화역 2번,372,202,170
2021,4,A,2110637,송정역 2번,540,357,183
2021,4,A,2110636,방화역 2번,152,76,76
2021,4,A,2110635,공항시장역 3번,1482,399,1083
2021,4,A,2110634,송정역 3번,664,434,230
2021,4,A,2110633,개화산역 1번,115,89,26
2021,4,A,2110632,방화역 3번,1075,887,188
2021,4,A,2110631,방화초등학교,359,177,182
2021,4,A,2110630,공항시장역 1번,1472,1008,464
2021,4,A,2110629,송정역 4번,190,107,83
2021,4,A,2110628,신목동역,496,319,177
2021,4,A,2110627,신정롯데캐슬아파트,512,310,202
2021,4,A,2110626,양화초등학교,652,271,381
2021,4,A,2110625,신정2동주민센터,726,454,272
2021,4,A,2110624,목동문화체육센터,382,234,148
2021,4,A,2110623,갈산공원,118,94,24
2021,4,A,2110622,달마을공원,458,261,197
2021,4,A,2110621,목동역 5번,111,57,54
2021,4,A,2110620,목동보건지소,451,235,216
2021,4,A,2110619,목4동주민센터,311,203,108
2021,4,A,2110618,강서고등학교,193,135,58
2021,4,A,2110617,등촌역 4번,274,192,82
2021,4,A,2110616,양목초등학교,161,103,58
2021,4,A,2110615,신서초등학교,87,63,24
2021,4,A,2110614,목동로데오거리,596,292,304
2021,4,A,2110613,신정네거리역 4번,80,20,60
2021,4,A,2110612,신정역 5번,644,303,341
2021,4,A,2110611,신정역 1번,316,212,104
2021,4,A,2110610,계남근린공원,126,85,41
2021,4,A,2110609,신정네거리역 2번,1377,1358,19
2021,4,A,2110608,신월2동주민센터,873,453,420
2021,4,A,2110607,금빛새마을금고본점,53,31,22
2021,4,A,2110606,신한은행 신월동지점,521,288,233
2021,4,A,2110605,목동센트럴아이파크앞,155,89,66
2021,4,A,2110604,신월4동주민센터,637,528,109
2021,4,A,2110603,지향초등학교,205,119,86
2021,4,A,2110602,신월시영아파트중문,644,574,70
2021,4,A,2110601,신월1동우편취급국,1200,814,386
2021,4,A,2110600,신월7동주민센터,350,263,87
2021,4,A,2110599,신월1파출소,378,268,110
2021,4,A,2110598,신월문화체육센터,428,195,233
2021,4,A,2110597,신월1동주민센터,517,302,215
2021,4,A,2110596,서서울호수공원,417,272,145
2021,4,A,2110595,메디힐병원,731,459,272
2021,4,A,2110594,신월중학교,453,225,228
2021,4,A,2110593,신월3동주민센터,304,157,147
2021,4,A,2110592,서울금융고등학교,449,344,105
2021,4,A,2110591,충정로역 6번,627,422,205
2021,4,A,2110590,만리재,97,50,47
2021,4,A,2110589,애오개역 3번,58,14,44
2021,4,A,2110588,한겨레신문사,169,92,77
2021,4,A,2110587,공덕동주민센터,238,121,117
2021,4,A,2110586,서울서부지방법원,1461,863,598
2021,4,A,2110585,마포경찰서,918,790,128
2021,4,A,2110584,아현역 4번,49,13,36
2021,4,A,2110583,공덕래미안3차아파트,316,164,152
2021,4,A,2110582,이대역 5번,59,19,40
2021,4,A,2110581,염리초등학교,16,11,5
2021,4,A,2110580,양원초등학교,78,20,58
2021,4,A,2110579,마포역 4번,758,561,197
2021,4,A,2110578,대흥역 2번,2091,1413,678
2021,4,A,2110577,용강동주민센터,145,105,40
2021,4,A,2110576,대흥역 3번,1605,1112,493
2021,4,A,2110575,대흥동주민센터,206,156,50
2021,4,A,2110574,서강대학교,173,123,50
2021,4,A,2110573,신촌역 6번,33,14,19
2021,4,A,2110572,서강대역 1번,470,254,216
2021,4,A,2110571,신수동주민센터,635,358,277
2021,4,A,2110570,KB국민은행 서강지점,61,39,22
2021,4,A,2110569,홍대땡땡거리,358,153,205
2021,4,A,2110568,광흥창역 1번,67,32,35
2021,4,A,2110567,광흥창역 6번,91,61,30
2021,4,A,2110566,경의선책거리,1690,934,756
2021,4,A,2110565,홍익대,107,64,43
2021,4,A,2110564,홍대입구역 3번,471,211,260
2021,4,A,2110563,상수역 3번,355,274,81
2021,4,A,2110562,연트럴파크(연남동주민센터),426,237,189
2021,4,A,2110561,상수역 4번,395,247,148
2021,4,A,2110560,마포FM,292,140,152
2021,4,A,2110559,성산중학교,757,474,283
2021,4,A,2110558,경성고등학교,2338,1579,759
2021,4,A,2110557,홍대부속여중고앞,760,465,295
2021,4,A,2110556,절두산순교성지,176,112,64
2021,4,A,2110555,홍익지구대,335,161,174
2021,4,A,2110554,망원역 1번,1499,727,772
2021,4,A,2110553,가좌역 2번,257,150,107
2021,4,A,2110552,성미산체육관,646,469,177
2021,4,A,2110551,성서초등학교,803,387,416
2021,4,A,2110550,합정역 8번,1578,740,838
2021,4,A,2110549,새터산,283,137,146
2021,4,A,2110548,마포구청역 4번,795,475,320
2021,4,A,2110547,KB국민은행 망원동지점,284,168,116
2021,4,A,2110546,양화대교북단,684,408,276
2021,4,A,2110545,마포구청역 1번,880,496,384
2021,4,A,2110544,망리단길,1203,718,485
2021,4,A,2110543,중암중학교,38,25,13
2021,4,A,2110542,마포구청역 7번,4013,2450,1563
2021,4,A,2110541,동교초등학교,377,221,156
2021,4,A,2110540,망원나들목체육관,288,154,134
2021,4,A,2110539,미근동,2792,1821,971
2021,4,A,2110538,충정로역 3번,284,178,106
2021,4,A,2110537,충정로현대아파트,1514,848,666
2021,4,A,2110536,돈의문센트레빌아파트입구,141,105,36
2021,4,A,2110535,영천시장입구,797,440,357
2021,4,A,2110534,경기대학교,134,67,67
2021,4,A,2110533,충정로역 7번,22,11,11
2021,4,A,2110532,아현역 2번,330,205,125
2021,4,A,2110531,홍지문,141,61,80
2021,4,A,2110530,아현역 1번,36,20,16
2021,4,A,2110529,홍제3동주민센터,136,67,69
2021,4,A,2110528,서울여자간호대학교,309,149,160
2021,4,A,2110527,홍제역 2번,177,83,94
2021,4,A,2110526,봉원사,241,122,119
2021,4,A,2110525,홍은종합사회복지관,61,17,44
2021,4,A,2110524,연희세브란스병원,55,23,32
2021,4,A,2110523,홍제성원아파트,25,11,14
2021,4,A,2110522,홍제역 3번,8,3,5
2021,4,A,2110521,홍제역 4번,63,36,27
2021,4,A,2110520,경의중앙 신촌역,78,38,40
2021,4,A,2110519,서대문구보건소별관,470,175,295
2021,4,A,2110518,서대문구청,117,70,47
2021,4,A,2110517,서대문소방서,1051,692,359
2021,4,A,2110516,정원여중,114,85,29
2021,4,A,2110515,홍은중학교,399,312,87
2021,4,A,2110514,서대문우체국,86,19,67
2021,4,A,2110513,연희파출소,457,241,216
2021,4,A,2110512,연희지하차도,357,183,174
2021,4,A,2110511,연희초등학교,3766,3317,449
2021,4,A,2110510,홍연시장,99,59,40
2021,4,A,2110509,연희대우아파트앞,691,333,358
2021,4,A,2110508,서연중학교,1028,470,558
2021,4,A,2110507,명지대학교,1537,1156,381
2021,4,A,2110506,연희임광아파트,110,66,44
2021,4,A,2110505,홍남교남측,14,9,5
2021,4,A,2110504,명지전문대,139,35,104
2021,4,A,2110503,명지대학교교회,230,123,107
2021,4,A,2110502,남가좌파출소,290,147,143
2021,4,A,2110501,연희어린이공원,214,82,132
2021,4,A,2110500,남가좌동현대아파트,74,54,20
2021,4,A,2110499,연가초등학교,282,123,159
2021,4,A,2110498,증산역 1번,222,102,120
2021,4,A,2110497,가좌역 3번,299,247,52
2021,4,A,2110496,모래내우체국,611,333,278
2021,4,A,2110495,북가좌2동주민센터,501,372,129
2021,4,A,2110494,증산3교남측,31,24,7
2021,4,A,2110493,북가좌초등학교,892,830,62
2021,4,A,2110492,하나고등학교,247,43,204
2021,4,A,2110491,불광중학교,195,90,105
2021,4,A,2110490,녹번동근린공원,307,166,141
2021,4,A,2110489,불광역 3번,35,25,10
2021,4,A,2110488,우리은행응암동지점,171,103,68
2021,4,A,2110487,불광역 8번,63,35,28
2021,4,A,2110486,은평구청,629,292,337
2021,4,A,2110485,연신내우체국,1259,678,581
2021,4,A,2110484,역촌역 3번,500,203,297
2021,4,A,2110483,연천초등학교,147,90,57
2021,4,A,2110482,연신초등학교,45,19,26
2021,4,A,2110481,불광역 7번,193,86,107
2021,4,A,2110480,연신내역 3번,117,34,83
2021,4,A,2110479,연신내역 2번,304,177,127
2021,4,A,2110478,응암1동주민센터,359,221,138
2021,4,A,2110477,은평세무서,434,205,229
2021,4,A,2110476,역촌역 2번,56,26,30
2021,4,A,2110475,백련산해모로아파트,241,126,115
2021,4,A,2110474,세명컴퓨터고등학교,196,68,128
2021,4,A,2110473,구산역 1번,436,241,195
2021,4,A,2110472,연신내역 4번,336,156,180
2021,4,A,2110471,응암동우체국,258,110,148
2021,4,A,2110470,신진과학기술고등학교,127,78,49
2021,4,A,2110469,응암정보도서관,340,184,156
2021,4,A,2110468,응암역 3번,1129,494,635
2021,4,A,2110467,은평요양병원,487,284,203
2021,4,A,2110466,구산역 2번,87,46,41
2021,4,A,2110465,연신내역 7번,229,110,119
2021,4,A,2110464,연신내역 5번,301,170,131
2021,4,A,2110463,응암3동주민센터,123,54,69
2021,4,A,2110462,갈현건영아파트,354,220,134
2021,4,A,2110461,새절역 2번,39,21,18
2021,4,A,2110460,구산역 4번,969,582,387
2021,4,A,2110459,응암역 2번,547,198,349
2021,4,A,2110458,선일여고,404,211,193
2021,4,A,2110457,예일여고,484,284,200
2021,4,A,2110456,구산보건지소,966,543,423
2021,4,A,2110455,역촌노인복지관,678,360,318
2021,4,A,2110454,선정중학교,481,268,213
2021,4,A,2110453,신사1동주민센터,515,288,227
2021,4,A,2110452,새절역 3번,420,347,73
2021,4,A,2110451,증산역 4번,1296,986,310
2021,4,A,2110450,시립서북병원,1576,644,932
2021,4,A,2110449,증산역 3번,717,414,303
2021,4,A,2110448,상신초등학교입구,120,76,44
2021,4,A,2110447,구산초등학교,12,7,5
2021,4,A,2110446,내를건너서숲으로도서관,375,294,81
2021,4,A,2110445,덕산중학교,61,45,16
2021,4,A,2110444,수색성당,170,73,97
2021,4,A,2110443,수색역 1번,14,7,7
2021,4,A,2110442,화랑대철도공원,76,20,56
2021,4,A,2110441,영신여고,172,78,94
2021,4,A,2110440,상계3동4동주민센터,49,16,33
2021,4,A,2110439,당고개역 5번,63,21,42
2021,4,A,2110438,경춘선숲길 우측,230,110,120
2021,4,A,2110437,당고개역 2번,116,40,76
2021,4,A,2110436,상계제일중학교,93,60,33
2021,4,A,2110435,서울과학기술대,73,40,33
2021,4,A,2110434,태릉입구역 4번,121,62,59
2021,4,A,2110433,공릉역 2번,401,137,264
2021,4,A,2110432,대진고등학교,894,734,160
2021,4,A,2110431,상계역,124,72,52
2021,4,A,2110430,중계초등학교,307,114,193
2021,4,A,2110429,공릉동 국수거리,2074,916,1158
2021,4,A,2110428,상계5동주민센터,491,217,274
2021,4,A,2110427,노원 을지대학교병원,363,281,82
2021,4,A,2110426,상계2동주민센터,337,169,168
2021,4,A,2110425,계상초등학교,130,54,76
2021,4,A,2110424,상계초등학교,388,157,231
2021,4,A,2110423,석계역 2번,280,104,176
2021,4,A,2110422,노원역 9번,277,221,56
2021,4,A,2110421,석계역 1번,249,109,140
2021,4,A,2110420,광운대역 1번,814,483,331
2021,4,A,2110419,수락산디자인거리,789,536,253
2021,4,A,2110418,광운대학교 남단,100,45,55
2021,4,A,2110417,월계역 3번,26,14,12
2021,4,A,2110416,노원초등학교,468,244,224
2021,4,A,2110415,수락산역 4번,635,386,249
2021,4,A,2110414,장석교회,61,47,14
2021,4,A,2110413,누원고등학교,54,33,21
2021,4,A,2110412,창동중학교,25,23,2
2021,4,A,2110411,도봉역 3번,413,368,45
2021,4,A,2110410,방학역 2번,957,833,124
2021,4,A,2110409,창동역 2번,3957,2958,999
2021,4,A,2110408,가인초등학교,359,108,251
2021,4,A,2110407,도봉역 2번,562,338,224
2021,4,A,2110406,도봉산역 1번,659,595,64
2021,4,A,2110405,방학역 1번,1123,365,758
2021,4,A,2110404,신창초등학교,520,300,220
2021,4,A,2110403,방학1동주민센터,316,167,149
2021,4,A,2110402,도봉구 정병원,471,221,250
2021,4,A,2110401,도봉구민회관,243,65,178
2021,4,A,2110400,도봉구보건소,191,111,80
2021,4,A,2110399,창2동주민센터,852,519,333
2021,4,A,2110398,쌍문2동우체국,474,326,148
2021,4,A,2110397,도봉산입구,469,257,212
2021,4,A,2110396,쌍문역1번(쌍리단길),259,94,165
2021,4,A,2110395,신한은행 방학동지점,163,42,121
2021,4,A,2110394,방학중학교,193,116,77
2021,4,A,2110393,국민은행방학지점,49,13,36
2021,4,A,2110392,발바닥공원,43,17,26
2021,4,A,2110391,샘말어린이공원,373,154,219
2021,4,A,2110390,방학초등학교,225,105,120
2021,4,A,2110389,한일병원,209,120,89
2021,4,A,2110388,도봉우체국,35,23,12
2021,4,A,2110387,쌍문초등학교,335,185,150
2021,4,A,2110386,연산군묘,124,114,10
2021,4,A,2110385,효문고등학교,37,22,15
2021,4,A,2110384,문이교,248,138,110
2021,4,A,2110383,덕성여대시반거리,33,21,12
2021,4,A,2110382,솔밭공원역 1번,32,25,7
2021,4,A,2110381,번동주공2단지,171,88,83
2021,4,A,2110380,강북문화정보도서관,48,15,33
2021,4,A,2110379,KT&G 북부지사,12,3,9
2021,4,A,2110378,송중동주민센터,23,13,10
2021,4,A,2110377,미아사거리역 3번,21,14,7
2021,4,A,2110376,수송초등학교,224,142,82
2021,4,A,2110375,서울북부고용노동지청,178,99,79
2021,4,A,2110374,송중초등학교,491,272,219
2021,4,A,2110373,수유역 2번,891,705,186
2021,4,A,2110372,강북중학교,188,100,88
2021,4,A,2110371,삼양입구사거리,49,23,26
2021,4,A,2110370,도봉세무서,367,255,112
2021,4,A,2110369,성신여대운정그린캠퍼스,518,214,304
2021,4,A,2110368,송천초등학교,196,176,20
2021,4,A,2110367,강북구청,1943,976,967
2021,4,A,2110366,광산사거리,91,64,27
2021,4,A,2110365,미아역 5번,341,83,258
2021,4,A,2110364,미아역 8번,146,75,71
2021,4,A,2110363,송천동주민센터,19,12,7
2021,4,A,2110362,우이천 계성교,205,110,95
2021,4,A,2110361,삼양사거리역 1번,101,29,72
2021,4,A,2110360,수유초등학교,321,222,99
2021,4,A,2110359,수유시장옆,117,67,50
2021,4,A,2110358,인수동 우편취급국,558,300,258
2021,4,A,2110357,가오리역 1번,725,611,114
2021,4,A,2110356,덕수교,228,114,114
2021,4,A,2110355,삼양사거리역 2번,306,254,52
2021,4,A,2110354,삼각산119안전센터,22,5,17
2021,4,A,2110353,수유동우체국,187,91,96
2021,4,A,2110352,수유1동주민센터,305,121,184
2021,4,A,2110351,수유북부시장옆,214,93,121
2021,4,A,2110350,가오리역 2번,148,77,71
2021,4,A,2110349,화계역 2번,83,67,16
2021,4,A,2110348,강북문화예술회관,343,174,169
2021,4,A,2110347,구세군강북종합사회복지관,38,17,21
2021,4,A,2110346,4.19민주묘지역 2번,96,48,48
2021,4,A,2110345,솔밭공원역 2번,117,48,69
2021,4,A,2110344,화계중학교,12,10,2
2021,4,A,2110343,무너미어린이공원,100,74,26
2021,4,A,2110342,국립재활원,59,44,15
2021,4,A,2110341,북한산우이역 2번,492,408,84
2021,4,A,2110340,인수중학교,176,99,77
2021,4,A,2110339,국립4.19민주묘지,26,10,16
2021,4,A,2110338,인수초등학교,190,135,55
2021,4,A,2110337,아카데미하우스,512,368,144
2021,4,A,2110336,석관고등학교,94,84,10
2021,4,A,2110335,석계역 7번,249,172,77
2021,4,A,2110334,석관중앙교회,170,105,65
2021,4,A,2110333,돌곶이역 5번,988,746,242
2021,4,A,2110332,돌곶이역 3번,164,63,101
2021,4,A,2110331,돌곶이역 8번,436,292,144
2021,4,A,2110330,돌곶이역 1번,220,172,48
2021,4,A,2110329,우리은행체육관,53,27,26
2021,4,A,2110328,상월곡역 3번,250,157,93
2021,4,A,2110327,상월곡역 2번,104,55,49
2021,4,A,2110326,장위동성당,84,40,44
2021,4,A,2110325,장곡초등학교,62,22,40
2021,4,A,2110324,월곡역 4번,99,55,44
2021,4,A,2110323,상월곡역 1번,109,30,79
2021,4,A,2110322,장위1동주민센터,237,158,79
2021,4,A,2110321,동덕여대,43,29,14
2021,4,A,2110320,KB국민은행 종암동지점,72,44,28
2021,4,A,2110319,종암동주민센터,277,111,166
2021,4,A,2110318,KT월곡지사,148,78,70
2021,4,A,2110317,종암중학교,412,207,205
2021,4,A,2110316,숭곡초등학교,439,217,222
2021,4,A,2110315,종암아이파크2차,124,78,46
2021,4,A,2110314,종암경찰서,953,701,252
2021,4,A,2110313,안암역 3번,2079,1351,728
2021,4,A,2110312,안암역 2번,175,96,79
2021,4,A,2110311,종암아이파크2차후문,49,21,28
2021,4,A,2110310,길음역 10번,45,14,31
2021,4,A,2110309,대광초등학교,354,252,102
2021,4,A,2110308,길음역 8번,174,85,89
2021,4,A,2110307,길음역 7번,158,71,87
2021,4,A,2110306,미아초등학교,291,194,97
2021,4,A,2110305,보문역 5번,883,661,222
2021,4,A,2110304,보문역 4번,248,146,102
2021,4,A,2110303,성신여대입구역 1번,138,97,41
2021,4,A,2110302,보문역 8번,3818,3195,623
2021,4,A,2110301,성신여대입구역 7번,484,209,275
2021,4,A,2110300,삼선동주민센터,2735,1587,1148
2021,4,A,2110299,정릉역 1번,372,241,131
2021,4,A,2110298,솔숲어린이공원,77,28,49
2021,4,A,2110297,경동고등학교,654,311,343
2021,4,A,2110296,성신여대입구역 4번,77,39,38
2021,4,A,2110295,정릉우체국,679,248,431
2021,4,A,2110294,서경대학교,391,262,129
2021,4,A,2110293,삼선중학교,1730,860,870
2021,4,A,2110292,정릉역 2번,43,17,26
2021,4,A,2110291,한성대입구역 3번,345,174,171
2021,4,A,2110290,북한산보국문역 1번,96,78,18
2021,4,A,2110289,북한산보국문역 2번,144,105,39
2021,4,A,2110288,동구여중,216,139,77
2021,4,A,2110287,정릉3동주민센터,70,50,20
2021,4,A,2110286,한성대입구역 5번,978,468,510
2021,4,A,2110285,홍대부중,814,559,255
2021,4,A,2110284,정릉북한산국립공원입구,644,558,86
2021,4,A,2110283,성북초등학교앞,203,78,125
2021,4,A,2110282,국민대학교앞,1403,1162,241
2021,4,A,2110281,길상사,13811,12087,1724
2021,4,A,2110280,북정마을,78,40,38
2021,4,A,2110279,신내역 2번,9,8,1
2021,4,A,2110278,망우본동주민센터,279,168,111
2021,4,A,2110277,러스크서울병원,178,100,78
2021,4,A,2110276,신내IC북측,39,25,14
2021,4,A,2110275,하나은행 망우동지점,63,33,30
2021,4,A,2110274,서일대학교,552,385,167
2021,4,A,2110273,장스여성병원,610,446,164
2021,4,A,2110272,신내1동주민센터,471,318,153
2021,4,A,2110271,신내역 1번,97,74,23
2021,4,A,2110270,혜원여고,168,148,20
2021,4,A,2110269,용마문화복지센터,169,98,71
2021,4,A,2110268,망우3동주민센터,60,30,30
2021,4,A,2110267,망우역 2번,139,49,90
2021,4,A,2110266,면목동우체국,225,182,43
2021,4,A,2110265,망우역 1번,198,91,107
2021,4,A,2110264,면목역 2번,358,170,188
2021,4,A,2110263,면목역 1번,128,69,59
2021,4,A,2110262,상봉역 3번,1532,879,653
2021,4,A,2110261,사가정역 4번,167,90,77
2021,4,A,2110260,면목역 3번,126,74,52
2021,4,A,2110259,사가정역 1번,543,425,118
2021,4,A,2110258,면동초등학교,260,99,161
2021,4,A,2110257,상봉역 7번,397,330,67
2021,4,A,2110256,면목2동체육관,477,321,156
2021,4,A,2110255,상봉역 4번,327,208,119
2021,4,A,2110254,오거리공원,257,89,168
2021,4,A,2110253,중곡초등학교,181,106,75
2021,4,A,2110252,장안제일시장,712,505,207
2021,4,A,2110251,장안중학교,147,104,43
2021,4,A,2110250,화랑대역 7번,111,69,42
2021,4,A,2110249,중화역 1번,783,496,287
2021,4,A,2110248,먹골파출소,85,47,38
2021,4,A,2110247,먹골역 1번,377,175,202
2021,4,A,2110246,월드순복음교회,431,312,119
2021,4,A,2110245,KB국민은행 중화동지점,108,69,39
2021,4,A,2110244,중화역 4번,250,175,75
2021,4,A,2110243,중랑노인종합복지관,317,126,191
2021,4,A,2110242,면목5동주민센터,164,112,52
2021,4,A,2110241,먹골역 5번,415,213,202
2021,4,A,2110240,태릉시장 특화거리,97,39,58
2021,4,A,2110238,배꽃어린이공원,66,48,18
2021,4,A,2110237,메가박스 상봉,274,152,122
2021,4,A,2110236,신묵초등학교,1015,836,179
2021,4,A,2110235,세화어린이공원,17,12,5
2021,4,A,2110234,중랑역 4번,96,41,55
2021,4,A,2110233,중랑역 1번,142,46,96
2021,4,A,2110232,동대부고,579,413,166
2021,4,A,2110231,장안교,11,8,3
2021,4,A,2110230,장안현대홈타운1차아파트,161,101,60
2021,4,A,2110229,장평중학교,1339,865,474
2021,4,A,2110228,장안근린공원,1992,1184,808
2021,4,A,2110227,답십리공원,216,82,134
2021,4,A,2110226,장안1동주민센터,1882,1005,877
2021,4,A,2110225,촬영소사거리,330,204,126
2021,4,A,2110224,외대앞역 2번,95,39,56
2021,4,A,2110223,군자초등학교,94,56,38
2021,4,A,2110222,회기역 2번,20,17,3
2021,4,A,2110221,의릉,95,69,26
2021,4,A,2110220,외대앞역 1번,190,109,81
2021,4,A,2110219,삼육보건대학교,249,145,104
2021,4,A,2110218,답십리사거리,158,83,75
2021,4,A,2110217,자동차부품상가,503,388,115
2021,4,A,2110216,전농중학교,208,68,140
2021,4,A,2110215,회기역 1번,28,18,10
2021,4,A,2110214,경희대후문,86,42,44
2021,4,A,2110213,청량초등학교,124,81,43
2021,4,A,2110212,답십리초등학교,204,144,60
2021,4,A,2110211,전곡마을마당공원,626,445,181
2021,4,A,2110210,서울시립대,341,253,88
2021,4,A,2110209,답십리 장령당공원,81,51,30
2021,4,A,2110208,시조사삼거리,75,56,19
2021,4,A,2110207,시립대앞사거리,50,26,24
2021,4,A,2110206,텃골근린공원,81,29,52
2021,4,A,2110205,경희대삼거리,82,48,34
2021,4,A,2110204,간데메공원,411,268,143
2021,4,A,2110203,떡전교사거리,99,63,36
2021,4,A,2110202,전농1동주민센터(전농시장),111,68,43
2021,4,A,2110201,전농119안전센터,27,11,16
2021,4,A,2110200,동대문경찰서,74,50,24
2021,4,A,2110199,홍릉시장,65,41,24
2021,4,A,2110198,동대문중앙새마을금고본점,67,26,41
2021,4,A,2110197,세종대왕기념관교차로,67,46,21
2021,4,A,2110196,홍릉근린공원,23,12,11
2021,4,A,2110195,동대문구청,221,115,106
2021,4,A,2110194,홍파초등학교,112,85,27
2021,4,A,2110193,고려대역 4번,48,37,11
2021,4,A,2110192,동의보감타워,70,45,25
2021,4,A,2110191,고려대역 6번,48,41,7
2021,4,A,2110190,고대앞사거리,195,92,103
2021,4,A,2110189,제기동역 1번,1545,1089,456
2021,4,A,2110188,용두동신동아아파트,807,607,200
2021,4,A,2110187,제기동역 6번,3124,2222,902
2021,4,A,2110186,종암초등학교,94,71,23
2021,4,A,2110185,용두초등학교,122,77,45
2021,4,A,2110184,용두사거리,423,215,208
2021,4,A,2110183,한국의류시험연구원,833,441,392
2021,4,A,2110182,용두희망어린이공원,370,249,121
2021,4,A,2110181,신설동역 9번,1864,1212,652
2021,4,A,2110180,광진정보도서관,5946,4025,1921
2021,4,A,2110179,광나루역 1번,911,620,291
2021,4,A,2110178,장로회신학대학교,194,123,71
2021,4,A,2110177,동의초등학교,135,90,45
2021,4,A,2110176,해오름공원,758,432,326
2021,4,A,2110175,푸른동산공원,370,235,135
2021,4,A,2110174,아차산역 1번,432,305,127
2021,4,A,2110173,구남초등학교,195,106,89
2021,4,A,2110172,광진초등학교,351,227,124
2021,4,A,2110171,중곡4동주민센터,59,36,23
2021,4,A,2110170,동대부여고,189,105,84
2021,4,A,2110169,성동초등학교,221,112,109
2021,4,A,2110168,대원고등학교,688,531,157
2021,4,A,2110167,용마초등학교,376,220,156
2021,4,A,2110166,구의1동주민센터,552,292,260
2021,4,A,2110165,국립정신건강센터,287,204,83
2021,4,A,2110164,아차산역 5번,731,494,237
2021,4,A,2110163,성자초등학교,272,134,138
2021,4,A,2110162,군자역 4번,613,365,248
2021,4,A,2110161,중곡역 3번,236,135,101
2021,4,A,2110160,광진경찰서,832,690,142
2021,4,A,2110159,구의역 4번,663,391,272
2021,4,A,2110158,중곡3동주민센터,715,518,197
2021,4,A,2110157,자양동우체국,1097,891,206
2021,4,A,2110156,군자역 5번,624,365,259
2021,4,A,2110155,광진구청,8356,7701,655
2021,4,A,2110154,광진정말공원,307,161,146
2021,4,A,2110153,중곡1동주민센터,241,83,158
2021,4,A,2110152,중곡어린이공원,338,300,38
2021,4,A,2110151,자양한강도서관,249,175,74
2021,4,A,2110150,중곡1동 마을마당,1179,698,481
2021,4,A,2110149,세종대학교,122,72,50
2021,4,A,2110148,어린이대공원역 3번,17,12,5
2021,4,A,2110147,능동우편취급국,815,464,351
2021,4,A,2110146,신자초등학교,735,531,204
2021,4,A,2110145,장안초등학교,7,4,3
2021,4,A,2110144,어린이대공원역 4번,47,23,24
2021,4,A,2110143,뚝섬유원지역 1번,63,26,37
2021,4,A,2110142,화양사거리,213,107,106
2021,4,A,2110141,건대입구역 1번,213,138,75
2021,4,A,2110140,건대입구역 6번,552,361,191
2021,4,A,2110139,자양4동주민센터,204,116,88
2021,4,A,2110138,송정체육공원,160,79,81
2021,4,A,2110137,성수초등학교,6605,4295,2310
2021,4,A,2110136,경수초등학교,4745,2743,2002
2021,4,A,2110135,성동세무서,355,182,173
2021,4,A,2110134,성수119안전센터,771,587,184
2021,4,A,2110133,서울교통공사,122,93,29
2021,4,A,2110132,성수2가3동주민센터,786,521,265
2021,4,A,2110131,성수동카페거리,4798,3110,1688
2021,4,A,2110130,답십리역 6번,105,89,16
2021,4,A,2110129,성원어린이공원,664,421,243
2021,4,A,2110128,성원중학교,1237,712,525
2021,4,A,2110127,성수1가1동주민센터,290,157,133
2021,4,A,2110126,서울숲역 1번,27,18,9
2021,4,A,2110125,사근동살곶이상점가,135,83,52
2021,4,A,2110124,뚝섬역교차로,1253,1006,247
2021,4,A,2110123,마장역 3번,511,382,129
2021,4,A,2110122,마장역 2번,464,271,193
2021,4,A,2110121,한양대역 4번,45,30,15
2021,4,A,2110120,서울숲카페거리,79,49,30
2021,4,A,2110119,마장지하차도,127,89,38
2021,4,A,2110118,왕십리역 9번,697,487,210
2021,4,A,2110117,성동구보건소,103,73,30
2021,4,A,2110116,청계천박물관,4884,3674,1210
2021,4,A,2110115,상왕십리역 3번,945,362,583
2021,4,A,2110114,왕십리파출소,68,21,47
2021,4,A,2110113,응봉산,77,43,34
2021,4,A,2110112,행당역 2번,205,100,105
2021,4,A,2110111,대현산장미원,51,40,11
2021,4,A,2110110,상왕십리역 6번,93,55,38
2021,4,A,2110109,금호삼성래미안아파트,92,39,53
2021,4,A,2110108,성동구립금호도서관,6,1,5
2021,4,A,2110107,금호사거리,37,30,7
2021,4,A,2110105,금동어린이공원,43,20,23
2021,4,A,2110104,신금호역 4번,275,189,86
2021,4,A,2110103,옥수터널,13,11,2
2021,4,A,2110102,옥수역 6번,3362,1140,2222
2021,4,A,2110101,옥정중학교,218,121,97
2021,4,A,2110100,옥수동우편취급국,46,31,15
2021,4,A,2110099,유엔빌리지길,12646,10311,2335
2021,4,A,2110098,서울독일학교,242,91,151
2021,4,A,2110097,한남초등학교,3116,1920,1196
2021,4,A,2110096,한남힐사이드아파트,4186,2661,1525
2021,4,A,2110095,한강진역 3번,1186,801,385
2021,4,A,2110094,오산중학교,26,12,14
2021,4,A,2110093,우사단길,2482,1548,934
2021,4,A,2110092,NH농협은행 보광동지점,514,208,306
2021,4,A,2110091,리움미술관,1106,810,296
2021,4,A,2110090,한국폴리텍대학서울정수캠퍼스,3968,2447,1521
2021,4,A,2110089,서빙고동주민센터,752,503,249
2021,4,A,2110088,오산고등학교,1696,1140,556
2021,4,A,2110087,이태원엔틱가구거리,463,213,250
2021,4,A,2110086,이태원역 북측,9251,3612,5639
2021,4,A,2110085,경리단길남측,532,260,272
2021,4,A,2110084,경리단길북측,315,168,147
2021,4,A,2110083,서빙고역 1번,149,109,40
2021,4,A,2110082,용산구청,1571,779,792
2021,4,A,2110081,해방촌 남동측,291,170,121
2021,4,A,2110080,해방촌예술마을,277,160,117
2021,4,A,2110079,후암동주민센터,1084,584,500
2021,4,A,2110078,이촌동점보아파트,69,29,40
2021,4,A,2110077,삼광초등학교,385,317,68
2021,4,A,2110076,삼각지역 14번,537,175,362
2021,4,A,2110075,숙대입구역 1번,1630,736,894
2021,4,A,2110074,서울역 12번,8149,1751,6398
2021,4,A,2110073,삼각지역 3번,7916,2353,5563
2021,4,A,2110072,열정도,374,244,130
2021,4,A,2110071,한강미주맨션아파트,281,182,99
2021,4,A,2110070,용산세무서,184,130,54
2021,4,A,2110069,숙대입구,829,295,534
2021,4,A,2110068,남영역 1번,1039,595,444
2021,4,A,2110067,배문고등학교,1574,907,667
2021,4,A,2110066,서울역 15번,748,467,281
2021,4,A,2110065,남정초등학교,137,92,45
2021,4,A,2110064,효창공원앞역 2번,925,527,398
2021,4,A,2110063,효창공원앞역 5번,530,347,183
2021,4,A,2110062,한강로동땡땡거리(은행나무길),5667,3458,2209
2021,4,A,2110061,효창동주민센터,473,301,172
2021,4,A,2110060,효창공원앞역 6번,291,174,117
2021,4,A,2110059,새남터성지,385,307,78
2021,4,A,2110058,성심여자고등학교,947,659,288
2021,4,A,2110057,황학코아루아파트,57,39,18
2021,4,A,2110056,신당역 3번,506,288,218
2021,4,A,2110055,황학동벼룩시장,29,19,10
2021,4,A,2110054,청구역 3번,1537,849,688
2021,4,A,2110053,청구역 1번,281,166,115
2021,4,A,2110052,장충초등학교,484,281,203
2021,4,A,2110051,한양공고앞 교차로,111,82,29
2021,4,A,2110050,약수역 7번,309,230,79
2021,4,A,2110049,장충단 고개,2303,1240,1063
2021,4,A,2110048,장충동주민센터,5312,2706,2606
2021,4,A,2110047,다산성곽길,160,89,71
2021,4,A,2110046,버티고개,106,76,30
2021,4,A,2110045,동대문역사문화공원역 5번,234,174,60
2021,4,A,2110044,관성묘,405,300,105
2021,4,A,2110043,충무초등학교,1202,670,532
2021,4,A,2110042,남산골공원옆,994,621,373
2021,4,A,2110041,남산케이블카,967,435,532
2021,4,A,2110040,중구회현체육센터(정화예술대남산캠퍼스),165,78,87
2021,4,A,2110039,회현역 1번,49,26,23
2021,4,A,2110038,경향신문사,2636,1651,985
2021,4,A,2110037,신설동역 12번,208,124,84
2021,4,A,2110036,동묘앞역 3번,65,42,23
2021,4,A,2110035,동묘앞역 2번,276,161,115
2021,4,A,2110034,창신1동주민센터,41,35,6
2021,4,A,2110033,창신역 4번,166,89,77
2021,4,A,2110032,수족관거리,31,16,15
2021,4,A,2110031,창신역 1번,44,31,13
2021,4,A,2110030,동대문역 3번,10,5,5
2021,4,A,2110029,동대문역 1번,235,61,174
2021,4,A,2110028,이화달팽이길,704,279,425
2021,4,A,2110027,혜화역 1번,617,366,251
2021,4,A,2110026,종로5가역 4번,190,120,70
2021,4,A,2110025,충신시장옆,213,129,84
2021,4,A,2110024,혜회동주민센터,928,263,665
2021,4,A,2110023,서울대병원,186,55,131
2021,4,A,2110022,경신고등학교,537,396,141
2021,4,A,2110021,성균관대학교,387,297,90
2021,4,A,2110020,서울국제고등학교,639,315,324
2021,4,A,2110019,창덕궁,325,215,110
2021,4,A,2110018,중앙고등학교,888,439,449
2021,4,A,2110017,정독도서관,650,322,328
2021,4,A,2110016,평창동동측,7589,3104,4485
2021,4,A,2110015,청와대사랑채,578,345,233
2021,4,A,2110014,경복고등학교,194,82,112
2021,4,A,2110013,체부동홍종문가옥,119,70,49
2021,4,A,2110012,성곡미술관,1061,503,558
2021,4,A,2110011,청운초등학교,263,188,75
2021,4,A,2110010,평창동서측,6687,3622,3065
2021,4,A,2110009,자하문터널,950,463,487
2021,4,A,2110008,배화여자대학교(박노수미술관),552,379,173
2021,4,A,2110007,사직공원(한국사회과학도서관),283,185,98
2021,4,A,2110006,부암동주민센터,27,16,11
2021,4,A,2110005,세검정,1006,510,496
2021,4,A,2110004,대신고등학교,32,14,18
2021,4,A,2110003,세검정초등학교,485,315,170
2021,4,A,2110002,독립문역 1번,475,121,354
2021,4,A,2110001,이북5도청사,1066,638,428
